"lang"
{
"Language"	"schinese"
"Tokens"
{
"DOTA_Tooltip_ability_item_bag_of_gold"	"金袋"
"[english]DOTA_Tooltip_ability_item_bag_of_gold"	"Bag of Gold"
"DOTA_GameMode_15"	"暗月来袭"
"[english]DOTA_GameMode_15"	"Dark Moon"
"DOTA_GameMode_19"	"暗月来袭"
"[english]DOTA_GameMode_19"	"Dark Moon"
"DOTA_HUD_Round"	"回合"
"[english]DOTA_HUD_Round"	"ROUND"
"DOTA_HUD_EnemiesRemaining"	"剩余敌人："
"[english]DOTA_HUD_EnemiesRemaining"	"ENEMIES REMAINING:"
"DOTA_HUD_NextRound"	"下一轮："
"[english]DOTA_HUD_NextRound"	"NEXT ROUND: "
"DOTA_HUD_RoundStart"	"本轮开始！"
"[english]DOTA_HUD_RoundStart"	"ROUND START!"
"DOTA_HUD_Victory"	"胜利！"
"[english]DOTA_HUD_Victory"	"VICTORY!"
"DOTA_HUD_Defeat"	"失败！"
"[english]DOTA_HUD_Defeat"	"DEFEAT!"
"DOTA_HUD_Kills"	"击杀"
"[english]DOTA_HUD_Kills"	"KILLS"
"DOTA_HUD_Deaths"	"死亡"
"[english]DOTA_HUD_Deaths"	"DEATHS"
"DOTA_HUD_Saves"	"复活"
"[english]DOTA_HUD_Saves"	"REVIVES"
"DOTA_HUD_Bags"	"金袋"
"[english]DOTA_HUD_Bags"	"BAGS"
"DOTA_HUD_PlayAgain"	"再玩一次？"
"[english]DOTA_HUD_PlayAgain"	"Play Again?"
"DOTA_HUD_Yes"	"好的"
"[english]DOTA_HUD_Yes"	"YES"
"DOTA_HUD_No"	"不要"
"[english]DOTA_HUD_No"	"NO"
"DOTA_HUD_Score"	"本轮得分"
"[english]DOTA_HUD_Score"	"ROUND SCORE"
"DOTA_HUD_TowersRemaining"	"剩余防御塔"
"[english]DOTA_HUD_TowersRemaining"	"TOWERS REMAINING"
"DOTA_HUD_GoldBags"	"已收集金袋"
"[english]DOTA_HUD_GoldBags"	"GOLD BAGS COLLECTED"
"DOTA_HUD_GoldBagsMissed"	"未拾取金袋"
"[english]DOTA_HUD_GoldBagsMissed"	"GOLD BAGS MISSED"
"DOTA_HUD_TeamDeaths"	"团队死亡"
"[english]DOTA_HUD_TeamDeaths"	"TEAM DEATHS"
"DOTA_HUD_DarkMoonPoints"	"积分"
"[english]DOTA_HUD_DarkMoonPoints"	"POINTS"
"DOTA_HUD_ThisRound"	"本轮积分"
"[english]DOTA_HUD_ThisRound"	"POINTS THIS ROUND"
"DOTA_HUD_TotalPoints"	"本比赛总积分"
"[english]DOTA_HUD_TotalPoints"	"TOTAL POINTS EARNED THIS MATCH"
"DOTA_HUD_RankThisRound"	"本轮排名"
"[english]DOTA_HUD_RankThisRound"	"RANK THIS ROUND"
"DOTA_HUD_RankInfoIcon"	"排名是根据剩余防御塔、已收集金袋和团队死亡总数决定的。排名不会影响获得的积分。"
"[english]DOTA_HUD_RankInfoIcon"	"Rank is determined based off performance on Towers Remaining, Gold Bags Collected, and Total Team Deaths.  Points earned are not affected by Rank."
"DOTA_HUD_Mute"	"屏蔽"
"[english]DOTA_HUD_Mute"	"MUTE"
"dota_game_end_victory_title_radiant"	"暗月已避免！"
"[english]dota_game_end_victory_title_radiant"	"Dark Moon Averted!"
"dota_game_end_victory_title_dire"	"失败！"
"[english]dota_game_end_victory_title_dire"	"Defeated!"
"DOTA_Holdout_Award_MostDeadly_Title"	"千手人屠"
"[english]DOTA_Holdout_Award_MostDeadly_Title"	"Most Deadly"
"DOTA_Holdout_Award_MostDeadly_Desc"	" 获得本轮最高击杀数"
"[english]DOTA_Holdout_Award_MostDeadly_Desc"	" got the most kills this round "
"DOTA_Holdout_Award_MostSaves_Title"	"救人水火"
"[english]DOTA_Holdout_Award_MostSaves_Title"	"Field Medic"
"DOTA_Holdout_Award_MostSaves_Desc"	" 本轮复活队友次数最多"
"[english]DOTA_Holdout_Award_MostSaves_Desc"	" revived the most other players this round "
"DOTA_Holdout_Award_MostBags_Title"	"闷声发大财"
"[english]DOTA_Holdout_Award_MostBags_Title"	"Eyes on the Prize"
"DOTA_Holdout_Award_MostBags_Desc"	" 本轮拾取的金袋最多"
"[english]DOTA_Holdout_Award_MostBags_Desc"	" picked up the most gold bags this round "
"DOTA_Holdout_Award_LeastDeaths_Title"	"生命诚可贵"
"[english]DOTA_Holdout_Award_LeastDeaths_Title"	"Stayin' Alive"
"DOTA_Holdout_Award_LeastDeaths_Desc"	" 本轮死亡次数最少"
"[english]DOTA_Holdout_Award_LeastDeaths_Desc"	" had the least deaths this round "
"DOTA_Holdout_Award_MostPotions_Title"	"照单全收"
"[english]DOTA_Holdout_Award_MostPotions_Title"	"All for Me"
"DOTA_Holdout_Award_MostPotions_Desc"	" 本轮获得的药水最多"
"[english]DOTA_Holdout_Award_MostPotions_Desc"	" took the most potions this round "
"DOTA_Holdout_Award_Clutched_Title"	"独苗"
"[english]DOTA_Holdout_Award_Clutched_Title"	"Clutched"
"DOTA_Holdout_Award_Clutched_Desc"	" 本轮坚守到最后"
"[english]DOTA_Holdout_Award_Clutched_Desc"	" won the round as the last one alive "
"DOTA_Holdout_Award_MostDeaths_Title"	"有勇无谋？"
"[english]DOTA_Holdout_Award_MostDeaths_Title"	"Bravery, or Stupidity?"
"DOTA_Holdout_Award_MostDeaths_Desc"	" 本轮死亡次数最多"
"[english]DOTA_Holdout_Award_MostDeaths_Desc"	" had the most deaths that round "
"DOTA_Holdout_Award_KillingSpree_Title"	"大杀特杀"
"[english]DOTA_Holdout_Award_KillingSpree_Title"	"Killing Spree"
"DOTA_Holdout_Award_KillingSpree_Desc"	" 连续击杀100个敌人而且没有阵亡"
"[english]DOTA_Holdout_Award_KillingSpree_Desc"	" has a streak of 100 kills without dying "
"DOTA_Holdout_Award_Dominating_Title"	"主宰战场"
"[english]DOTA_Holdout_Award_Dominating_Title"	"Dominating"
"DOTA_Holdout_Award_Dominating_Desc"	" 连续击杀200个敌人而且没有阵亡"
"[english]DOTA_Holdout_Award_Dominating_Desc"	" has a streak of 200 kills without dying "
"DOTA_Holdout_Award_MegaKill_Title"	"杀人如芥"
"[english]DOTA_Holdout_Award_MegaKill_Title"	"Mega Kill"
"DOTA_Holdout_Award_MegaKill_Desc"	" 连续击杀300个敌人而且没有阵亡"
"[english]DOTA_Holdout_Award_MegaKill_Desc"	" has a streak of 300 kills without dying "
"DOTA_Holdout_Award_Unstoppable_Title"	"无人可挡"
"[english]DOTA_Holdout_Award_Unstoppable_Title"	"Unstoppable"
"DOTA_Holdout_Award_Unstoppable_Desc"	" 连续击杀400个敌人而且没有阵亡"
"[english]DOTA_Holdout_Award_Unstoppable_Desc"	" has a streak of 400 kills without dying "
"DOTA_Holdout_Award_WickedSick_Title"	"杀人不眨眼"
"[english]DOTA_Holdout_Award_WickedSick_Title"	"Wicked Sick"
"DOTA_Holdout_Award_WickedSick_Desc"	" 连续击杀500个敌人而且没有阵亡"
"[english]DOTA_Holdout_Award_WickedSick_Desc"	" has a streak of 500 kills without dying "
"DOTA_Holdout_Award_MonsterKill_Title"	"杀人魔王"
"[english]DOTA_Holdout_Award_MonsterKill_Title"	"Monster Kill"
"DOTA_Holdout_Award_MonsterKill_Desc"	" 连续击杀600个敌人而且没有阵亡"
"[english]DOTA_Holdout_Award_MonsterKill_Desc"	" has a streak of 600 kills without dying "
"DOTA_Holdout_Award_GodLike_Title"	"如神杀戮"
"[english]DOTA_Holdout_Award_GodLike_Title"	"Godlike"
"DOTA_Holdout_Award_GodLike_Desc"	" 连续击杀700个敌人而且没有阵亡"
"[english]DOTA_Holdout_Award_GodLike_Desc"	" has a streak of 700 kills without dying "
"DOTA_Holdout_Award_Beyond_GodLike_Title"	"超神屠戮"
"[english]DOTA_Holdout_Award_Beyond_GodLike_Title"	"Beyond Godlike"
"DOTA_Holdout_Award_Beyond_GodLike_Desc"	" 连续击杀800个敌人而且没有阵亡"
"[english]DOTA_Holdout_Award_Beyond_GodLike_Desc"	" has a streak of 800 kills without dying "
"DOTA_Holdout_Award_UltraKill_Title"	"究极杀戮"
"[english]DOTA_Holdout_Award_UltraKill_Title"	"Ultra Kill"
"DOTA_Holdout_Award_UltraKill_Desc"	" 短时间内杀死25个以上敌人"
"[english]DOTA_Holdout_Award_UltraKill_Desc"	" killed 25 or more creeps in a short time "
"DOTA_Holdout_Award_Rampage_Title"	"暴走"
"[english]DOTA_Holdout_Award_Rampage_Title"	"RAMPAGE"
"DOTA_Holdout_Award_Rampage_Desc"	" 短时间内杀死50个以上敌人"
"[english]DOTA_Holdout_Award_Rampage_Desc"	" killed 50 or more creeps in a short time "
"DOTA_Tooltip_Ability_item_health_potion"	"生命药水"
"[english]DOTA_Tooltip_Ability_item_health_potion"	"Health Potion"
"DOTA_Tooltip_Ability_item_mana_potion"	"魔法药水"
"[english]DOTA_Tooltip_Ability_item_mana_potion"	"Mana Potion"
"DOTA_Tooltip_Ability_creature_aura_health_regen"	"治愈光环"
"[english]DOTA_Tooltip_Ability_creature_aura_health_regen"	"Healing Aura"
"DOTA_Tooltip_ability_creature_aura_health_regen_Description"	"施法者周围单位开始回复生命值。"
"[english]DOTA_Tooltip_ability_creature_aura_health_regen_Description"	"Regenerates health around the caster."
"DOTA_Tooltip_Ability_creature_acid_spray"	"爆裂"
"[english]DOTA_Tooltip_Ability_creature_acid_spray"	"Burst"
"DOTA_Tooltip_ability_creature_acid_spray_Description"	"僵尸死亡时会爆裂，对附近所有单位造成伤害。之后地上会留下一滩酸液，踏上即会受到伤害。"
"[english]DOTA_Tooltip_ability_creature_acid_spray_Description"	"Zombie explodes on death damaging everyone around it.  Leaves a pool of acid that damages enemies."
"DOTA_Tooltip_Ability_creature_summon_undead"	"召唤僵尸"
"[english]DOTA_Tooltip_Ability_creature_summon_undead"	"Summon Zombies"
"DOTA_Tooltip_ability_creature_summon_undead_Description"	"召唤一群僵尸。"
"[english]DOTA_Tooltip_ability_creature_summon_undead_Description"	"Summons a horde of zombies."
"DOTA_Tooltip_Ability_creature_zombie_berserk"	"狂热"
"[english]DOTA_Tooltip_Ability_creature_zombie_berserk"	"Berserk"
"DOTA_Tooltip_ability_creature_zombie_berserk_Description"	"激怒僵尸，给予他攻击和速度加成。"
"[english]DOTA_Tooltip_ability_creature_zombie_berserk_Description"	"Enrages the zombie giving bonus attack and movement speed."
"DOTA_Tooltip_Ability_custom_ogre_magi_bloodlust"	"肉体嗜血术"
"[english]DOTA_Tooltip_Ability_custom_ogre_magi_bloodlust"	"Carnal Bloodlust"
"DOTA_Tooltip_ability_custom_ogre_magi_bloodlust_Description"	"激起一个友方单位的狂暴，增加其移动和攻击速度。"
"[english]DOTA_Tooltip_ability_custom_ogre_magi_bloodlust_Description"	"Incites a frenzy in a friendly unit, increasing its movement speed and attack speed."
"DOTA_Tooltip_Ability_creature_melee_smash"	"猛击"
"[english]DOTA_Tooltip_Ability_creature_melee_smash"	"Smash"
"DOTA_Tooltip_ability_creature_melee_smash_Description"	"将食人魔面前的单位敲到地上去。"
"[english]DOTA_Tooltip_ability_creature_melee_smash_Description"	"Smashes targets in front of the ogre into the ground."
"DOTA_Tooltip_Ability_lesser_nightcrawler_pounce"	"突袭"
"[english]DOTA_Tooltip_Ability_lesser_nightcrawler_pounce"	"Pounce"
"DOTA_Tooltip_ability_lesser_nightcrawler_pounce_Description"	"向目标跳去，对经过的所有敌人造成伤害。"
"[english]DOTA_Tooltip_ability_lesser_nightcrawler_pounce_Description"	"Leaps towards a target and damages any targets encountered along its path."
"DOTA_Tooltip_Ability_creature_sprint"	"冲刺"
"[english]DOTA_Tooltip_Ability_creature_sprint"	"Sprint"
"DOTA_Tooltip_ability_creature_sprint_Description"	"激活后获得移动速度加成。"
"[english]DOTA_Tooltip_ability_creature_sprint_Description"	"Bonus movement speed when activated."
"DOTA_Tooltip_Ability_creature_slithereen_crush"	"重击"
"[english]DOTA_Tooltip_Ability_creature_slithereen_crush"	"Bash"
"DOTA_Tooltip_ability_creature_slithereen_crush_Description"	"击晕鱼人重击者周围的敌人。只有在2名以上英雄接近时才会施放。"
"[english]DOTA_Tooltip_ability_creature_slithereen_crush_Description"	"Enemies around the Slarbasher are stunned.  Only occurs when two or more heroes are near."
"DOTA_Tooltip_Ability_creature_force_of_nature"	"召唤树人"
"[english]DOTA_Tooltip_Ability_creature_force_of_nature"	"Summon Treant"
"DOTA_Tooltip_ability_creature_force_of_nature_Description"	"召唤树人为施法者战斗。需要一棵树进行转化。"
"[english]DOTA_Tooltip_ability_creature_force_of_nature_Description"	"Summons a treant to fight for the caster.  Requires a tree to convert."
"DOTA_Tooltip_Ability_creature_spin_web"	"织网"
"[english]DOTA_Tooltip_Ability_creature_spin_web"	"Spin Web"
"DOTA_Tooltip_ability_creature_spin_web_Description"	"编一张黏黏的蛛网。"
"[english]DOTA_Tooltip_ability_creature_spin_web_Description"	"A sticky web is spun."
"DOTA_Tooltip_Ability_creature_spawn_broodmother_eggs"	"产下蛛卵"
"[english]DOTA_Tooltip_Ability_creature_spawn_broodmother_eggs"	"Lay Eggs"
"DOTA_Tooltip_ability_creature_spawn_broodmother_eggs_Description"	"产下数个蛛卵。"
"[english]DOTA_Tooltip_ability_creature_spawn_broodmother_eggs_Description"	"Lays several eggs."
"DOTA_Tooltip_Ability_creature_self_haste"	"极速"
"[english]DOTA_Tooltip_Ability_creature_self_haste"	"Haste"
"DOTA_Tooltip_ability_creature_self_haste_Description"	"被动加成移动速度。"
"[english]DOTA_Tooltip_ability_creature_self_haste_Description"	"Passive movement speed bonus."
"DOTA_Tooltip_Ability_creature_hatch_broodmother"	"孵化"
"[english]DOTA_Tooltip_Ability_creature_hatch_broodmother"	"Hatch"
"DOTA_Tooltip_ability_creature_hatch_broodmother_Description"	"好像会出现不想要的东西。"
"[english]DOTA_Tooltip_ability_creature_hatch_broodmother_Description"	"Likely something undesirable."
"DOTA_Tooltip_Ability_creature_spawn_spider"	"孵化蜘蛛"
"[english]DOTA_Tooltip_Ability_creature_spawn_spider"	"Spawn Spiderlings"
"DOTA_Tooltip_ability_creature_spawn_spider_Description"	"孵化几只小蜘蛛去攻击附近目标。"
"[english]DOTA_Tooltip_ability_creature_spawn_spider_Description"	"Spawns several spiderlings to attack nearby targets."
"DOTA_Tooltip_Ability_creature_fire_breath"	"火焰气息"
"[english]DOTA_Tooltip_Ability_creature_fire_breath"	"Breathe Fire"
"DOTA_Tooltip_ability_creature_fire_breath_Description"	"施法者向前方吐出火焰，对扇形区域内单位造成伤害。不能被打断。"
"[english]DOTA_Tooltip_ability_creature_fire_breath_Description"	"A column of fire spews forth sweeping in an arc across the front of the caster.  Cannot be interrupted."
"DOTA_Tooltip_Ability_creature_aoe_spikes"	"撕裂大地"
"[english]DOTA_Tooltip_Ability_creature_aoe_spikes"	"Split Earth"
"DOTA_Tooltip_ability_creature_aoe_spikes_Description"	"大地皲裂，向目标区域释放一排尖刺。"
"[english]DOTA_Tooltip_ability_creature_aoe_spikes_Description"	"The earth splits and spikes upwards in an area around the target location."
"DOTA_Tooltip_Ability_creature_split_a"	"粉碎"
"[english]DOTA_Tooltip_Ability_creature_split_a"	"Crumble"
"DOTA_Tooltip_ability_creature_split_a_Description"	"傀儡体内的灵气注入到他每一个破碎的身体中。"
"[english]DOTA_Tooltip_ability_creature_split_a_Description"	"The spirit from the golem is transferred into the pieces of his shattered body."
"DOTA_Tooltip_Ability_creature_split_b"	"粉碎"
"[english]DOTA_Tooltip_Ability_creature_split_b"	"Crumble"
"DOTA_Tooltip_ability_creature_split_b_Description"	"傀儡体内的灵气注入到他每一个破碎的身体中。"
"[english]DOTA_Tooltip_ability_creature_split_b_Description"	"The spirit from the golem is transferred into the pieces of his shattered body."
"DOTA_Tooltip_Ability_creature_meat_hook"	"巨型肉钩"
"[english]DOTA_Tooltip_Ability_creature_meat_hook"	"Giant Meat Hook"
"DOTA_Tooltip_ability_creature_meat_hook_Description"	"给我过来！"
"[english]DOTA_Tooltip_ability_creature_meat_hook_Description"	"Get over here!"
"DOTA_Tooltip_Ability_creature_dismember"	"肢解"
"[english]DOTA_Tooltip_Ability_creature_dismember"	"Dismember"
"DOTA_Tooltip_ability_creature_dismember_Description"	"在一段时间内将目标肢解，持续造成伤害并且目标无法移动。"
"[english]DOTA_Tooltip_ability_creature_dismember_Description"	"Dismembers a target over time causing damage and holding them in place."
"DOTA_Tooltip_Ability_holdout_gyrocopter_homing_missile"	"发射导弹"
"[english]DOTA_Tooltip_Ability_holdout_gyrocopter_homing_missile"	"Launch Missile"
"DOTA_Tooltip_ability_holdout_gyrocopter_homing_missile_Description"	"向目标发射一枚追踪导弹。"
"[english]DOTA_Tooltip_ability_holdout_gyrocopter_homing_missile_Description"	"Launches a homing missile at a target."
"DOTA_Tooltip_Ability_holdout_ancient_apparition_ice_blast"	"冰晶爆轰"
"[english]DOTA_Tooltip_Ability_holdout_ancient_apparition_ice_blast"	"Ice Blast"
"DOTA_Tooltip_ability_holdout_ancient_apparition_ice_blast_Description"	"全地图打击目标的爆炸性冰球。"
"[english]DOTA_Tooltip_ability_holdout_ancient_apparition_ice_blast_Description"	"An explosive ball of icy hail that can be used to strike targets anywhere on the map."
"DOTA_Tooltip_Ability_creature_minor_chain_frost"	"连环霜冻"
"[english]DOTA_Tooltip_Ability_creature_minor_chain_frost"	"Chain Frost"
"DOTA_Tooltip_ability_creature_minor_chain_frost_Description"	"释放可以在英雄间弹跳的霜冻之球。"
"[english]DOTA_Tooltip_ability_creature_minor_chain_frost_Description"	"Releases an orb of frost that bounces between heroes."
"DOTA_Tooltip_modifier_holdout_gods_strength"	"神之力量"
"[english]DOTA_Tooltip_modifier_holdout_gods_strength"	"Gods Strength"
"DOTA_Tooltip_ability_holdout_gods_strength_Description"	"<font color='#70EA72'>斯温获得额外的力量和攻击力。斯温在神之力量效果下每杀死一个敌方单位，所有技能的冷却时间都会减少。此效果可以无限次叠加。</font>"
"[english]DOTA_Tooltip_ability_holdout_gods_strength_Description"	"<font color='#70EA72'>Sven gains bonus strength and damage.  Upon killing an enemy unit while under the effects of God's Strength, all of Sven's ability cooldowns are reduced.  This effect can occur an unlimited amount of times.</font>"
"DOTA_Tooltip_aura_health_regen"	"治愈光环"
"[english]DOTA_Tooltip_aura_health_regen"	"Healing Aura"
"DOTA_Tooltip_witch_buff"	"攻击速度加成"
"[english]DOTA_Tooltip_witch_buff"	"Attack Speed Bonus"
"DOTA_Tooltip_ice_blast_slow"	"冰晶爆轰减速"
"[english]DOTA_Tooltip_ice_blast_slow"	"Ice Blast Slow"
"DOTA_Tooltip_tower_fortification_modifier"	"防御强化"
"[english]DOTA_Tooltip_tower_fortification_modifier"	"Fortification"
"DOTA_Tooltip_creature_slithereen_crush_slow"	"眩晕"
"[english]DOTA_Tooltip_creature_slithereen_crush_slow"	"Stunned"
"npc_dota_creature_worg"	"座狼"
"[english]npc_dota_creature_worg"	"Worg"
"npc_dota_creature_alpha_worg"	"头狼"
"[english]npc_dota_creature_alpha_worg"	"Alpha Worg"
"npc_dota_creature_wildwing_laborer"	"温顺枭兽"
"[english]npc_dota_creature_wildwing_laborer"	"Tamed Wildwing"
"npc_dota_creature_dazzle"	"德尊侍僧"
"[english]npc_dota_creature_dazzle"	"Acolyte of Dezun"
"npc_dota_creature_hellbear"	"地狱之熊"
"[english]npc_dota_creature_hellbear"	"Hellbear"
"npc_dota_creature_nyx_assassin"	"狂热圣甲虫"
"[english]npc_dota_creature_nyx_assassin"	"Zealot Scarab"
"npc_dota_creature_morphling_small"	"小元素人"
"[english]npc_dota_creature_morphling_small"	"Lesser Elemental"
"npc_dota_creature_morphling_big"	"大元素人"
"[english]npc_dota_creature_morphling_big"	"Greater Elemental"
"npc_dota_creature_bonus_chicken"	"公鸡"
"[english]npc_dota_creature_bonus_chicken"	"Rooster"
"npc_dota_creature_warlock_golem"	"迷魂傀儡"
"[english]npc_dota_creature_warlock_golem"	"Enthralled Golem"
"npc_dota_creature_warlock"	"控魔师"
"[english]npc_dota_creature_warlock"	"Demon Charmer"
"npc_dota_creature_berserk_zombie"	"狂热僵尸"
"[english]npc_dota_creature_berserk_zombie"	"Berserk Zombie"
"npc_dota_creature_berserk_zombie_torso"	"狂热僵尸躯干"
"[english]npc_dota_creature_berserk_zombie_torso"	"Berserk Zombie Torso"
"npc_dota_creature_lifestealer"	"暴怒噬魂兽"
"[english]npc_dota_creature_lifestealer"	"Enraged Devourer"
"npc_dota_creature_kunkka_mini"	"新兵"
"[english]npc_dota_creature_kunkka_mini"	"Recruit"
"npc_dota_creature_kunkka_medium"	"队长"
"[english]npc_dota_creature_kunkka_medium"	"Captain"
"npc_dota_creature_kunkka_large"	"舰队上将"
"[english]npc_dota_creature_kunkka_large"	"Fleet Admiral"
"npc_dota_creature_tidehunter_mini"	"食虾猎人"
"[english]npc_dota_creature_tidehunter_mini"	"Krill-eater"
"npc_dota_creature_tidehunter_medium"	"食鲨猎人"
"[english]npc_dota_creature_tidehunter_medium"	"Shark-eater"
"npc_dota_creature_tidehunter_large"	"食鲸猎人"
"[english]npc_dota_creature_tidehunter_large"	"Whale-eater"
"npc_dota_creature_creep_melee"	"我是个小兵"
"[english]npc_dota_creature_creep_melee"	"I'm a Creep"
"npc_dota_creature_catapult"	"混沌投石器"
"[english]npc_dota_creature_catapult"	"Chaotic Hurler"
"npc_dota_creature_mappo"	"陷阱师"
"[english]npc_dota_creature_mappo"	"Trapper"
"npc_dota_creature_satyr_soulstealer"	"窃魂者"
"[english]npc_dota_creature_satyr_soulstealer"	"Soulstealer"
"npc_dota_creature_bonus_chicken2"	"肉山宝宝"
"[english]npc_dota_creature_bonus_chicken2"	"Baby Roshan"
"npc_dota_creature_night_stalker"	"猎手"
"[english]npc_dota_creature_night_stalker"	"Hunter"
"npc_dota_creature_enigma"	"深渊"
"[english]npc_dota_creature_enigma"	"The Abyss"
"npc_dota_creature_luna_mini"	"小月骑"
"[english]npc_dota_creature_luna_mini"	"Tiny Moon Rider"
"npc_dota_creature_mirana"	"银夜行者"
"[english]npc_dota_creature_mirana"	"Nightsilver Prowler"
"npc_dota_creature_techies_bomb_planter"	"投弹手"
"[english]npc_dota_creature_techies_bomb_planter"	"Bomber"
"npc_dota_creature_techies_land_mine"	"地雷"
"[english]npc_dota_creature_techies_land_mine"	"Land Mine"
"npc_dota_creature_techies_suicider"	"突进手"
"[english]npc_dota_creature_techies_suicider"	"Hurtler"
"npc_dota_creature_alchemist"	"金术士"
"[english]npc_dota_creature_alchemist"	"Al, the chemist"
"npc_dota_creature_quas_invoker"	"科瑞克斯学者"
"[english]npc_dota_creature_quas_invoker"	"Scholar of Koryx"
"npc_dota_creature_wex_invoker"	"托纳鲁斯心智"
"[english]npc_dota_creature_wex_invoker"	"Mind of Tornarus"
"npc_dota_creature_exort_invoker"	"加拉隆党羽"
"[english]npc_dota_creature_exort_invoker"	"Agent of Gallaron"
"npc_dota_creature_boss_invoker"	"暗黑魔导师"
"[english]npc_dota_creature_boss_invoker"	"The Dark Magus"
"npc_dota_holdout_tower"	"防御塔"
"[english]npc_dota_holdout_tower"	"Tower"
"npc_dota_holdout_goodguys_fort"	"神庙"
"[english]npc_dota_holdout_goodguys_fort"	"Temple"
"npc_dota_badguys_tower1_top"	"暗月防御塔"
"[english]npc_dota_badguys_tower1_top"	"Dark Moon Tower"
"DOTA_Holdout_Round_Worgs"	"杀狼有一手"
"[english]DOTA_Holdout_Round_Worgs"	"A Way With Worgs"
"DOTA_Holdout_Round_Birds"	"先别数小鸡"
"[english]DOTA_Holdout_Round_Birds"	"Don't Count Your Chickens"
"DOTA_Holdout_Round_Nyx_Hellbear"	"夜神夜神夜神"
"[english]DOTA_Holdout_Round_Nyx_Hellbear"	"Nyx Nyx Nyx"
"DOTA_Holdout_Round_Morphling"	"变体时间到"
"[english]DOTA_Holdout_Round_Morphling"	"It's Morphlin' Time"
"DOTA_Holdout_Round_Bonus1"	"派对雏丑"
"[english]DOTA_Holdout_Round_Bonus1"	"Party Fowl"
"DOTA_Holdout_Round_Warlock"	"来自我的暗黑魔典"
"[english]DOTA_Holdout_Round_Warlock"	"From My Black Grimoire"
"DOTA_Holdout_Round_Zombies"	"没你我们分崩离析"
"[english]DOTA_Holdout_Round_Zombies"	"We're Falling Apart Without You"
"DOTA_Holdout_Round_TideAndKunkka"	"潮涨众舟起"
"[english]DOTA_Holdout_Round_TideAndKunkka"	"A Rising Tide Lifts All Boats"
"DOTA_Holdout_Round_Catapults"	"检测到大量发射信号"
"[english]DOTA_Holdout_Round_Catapults"	"Numerous Launches Detected"
"DOTA_Holdout_Round_Bonus2"	"雊~~~雊~~~"
"[english]DOTA_Holdout_Round_Bonus2"	"Flock-a-doodle-doo"
"DOTA_Holdout_Round_NightStalker"	"猎杀中"
"[english]DOTA_Holdout_Round_NightStalker"	"On The Hunt"
"DOTA_Holdout_Round_Mirana"	"猫女郎来袭"
"[english]DOTA_Holdout_Round_Mirana"	"Attack Of The Cat Ladies"
"DOTA_Holdout_Round_Alchemist"	"炼金还当过术士"
"[english]DOTA_Holdout_Round_Alchemist"	"Albert Was A Chemist"
"DOTA_Holdout_Round_Techies"	"这是工程师大会"
"[english]DOTA_Holdout_Round_Techies"	"It's A Techies Convention"
"DOTA_Holdout_Round_Invokers"	"何人扰我？"
"[english]DOTA_Holdout_Round_Invokers"	"Who Threatens Our Concentration?"
"DOTA_Tooltip_ability_item_upgraded_mortar"	"火炮升级"
"[english]DOTA_Tooltip_ability_item_upgraded_mortar"	"Upgraded Mortar"
"DOTA_Tooltip_ability_item_upgraded_mortar_Description"	"永久提升目标防御塔的攻击力。"
"[english]DOTA_Tooltip_ability_item_upgraded_mortar_Description"	"Applies a permanent damage upgrade to the target tower."
"DOTA_Tooltip_ability_item_upgraded_mortar_bonus_per_upgrade"	"额外攻击力："
"[english]DOTA_Tooltip_ability_item_upgraded_mortar_bonus_per_upgrade"	"BONUS DAMAGE:"
"DOTA_Tooltip_ability_item_upgraded_barricade"	"进击的隔墙"
"[english]DOTA_Tooltip_ability_item_upgraded_barricade"	"Upgraded Barricade"
"DOTA_Tooltip_ability_item_upgraded_barricade_Description"	"永久提升目标防御塔的护甲和血量。"
"[english]DOTA_Tooltip_ability_item_upgraded_barricade_Description"	"Applies a permanent armor and hitpoint upgrade to the target tower."
"DOTA_Tooltip_ability_item_upgraded_barricade_hp_bonus_per_upgrade"	"生命上限加成："
"[english]DOTA_Tooltip_ability_item_upgraded_barricade_hp_bonus_per_upgrade"	"BONUS HP:"
"DOTA_Tooltip_ability_item_upgraded_barricade_armor_bonus_per_upgrade"	"护甲提升："
"[english]DOTA_Tooltip_ability_item_upgraded_barricade_armor_bonus_per_upgrade"	"BONUS ARMOR:"
"DOTA_Tooltip_ability_item_book_of_intelligence"	"智力卷轴"
"[english]DOTA_Tooltip_ability_item_book_of_intelligence"	"Scroll of Intelligence"
"DOTA_Tooltip_ability_item_book_of_intelligence_Description"	"智力值永久提升5点。"
"[english]DOTA_Tooltip_ability_item_book_of_intelligence_Description"	"Grants a permanent 5 Intelligence boost."
"DOTA_Tooltip_ability_item_book_of_strength"	"力量卷轴"
"[english]DOTA_Tooltip_ability_item_book_of_strength"	"Scroll of Strength"
"DOTA_Tooltip_ability_item_book_of_strength_Description"	"力量值永久提升5点。"
"[english]DOTA_Tooltip_ability_item_book_of_strength_Description"	"Grants a permanent 5 Strength boost."
"DOTA_Tooltip_ability_item_book_of_agility"	"敏捷卷轴"
"[english]DOTA_Tooltip_ability_item_book_of_agility"	"Scroll of Agility"
"DOTA_Tooltip_ability_item_book_of_agility_Description"	"敏捷值永久提升5点。"
"[english]DOTA_Tooltip_ability_item_book_of_agility_Description"	"Grants a permanent 5 Agility boost."
"DOTA_Tooltip_ability_item_tombstone"	"复活队友"
"[english]DOTA_Tooltip_ability_item_tombstone"	"Resurrect Teammate"
"DOTA_Chat_Tombstone_Pinged"	"有队友在这里阵亡了。"
"[english]DOTA_Chat_Tombstone_Pinged"	"Fallen teammate here."
"DOTA_Tooltip_ability_keeper_of_the_light_mana_overload"	"魔法超负荷"
"[english]DOTA_Tooltip_ability_keeper_of_the_light_mana_overload"	"Mana Overload"
"DOTA_Tooltip_ability_keeper_of_the_light_mana_overload_Description"	"释放纯净的魔法精华突袭敌人，造成大量伤害。如果在突袭过程中敌人阵亡，能量将会爆发，对附近所有敌人造成伤害。"
"[english]DOTA_Tooltip_ability_keeper_of_the_light_mana_overload_Description"	"Assaults an enemy with pure magical essence, causing heavy damage. If they die during the assault, they energy will burst forth, damaging all nearby enemies."
"DOTA_Tooltip_ability_keeper_of_the_light_mana_overload_Lore"	"伊扎洛召唤原初协律，用它的力量将敌人压倒。"
"[english]DOTA_Tooltip_ability_keeper_of_the_light_mana_overload_Lore"	"Ezalor calls upon Primordial harmony, overwhelming his enemies with its power."
"DOTA_Tooltip_ability_keeper_of_the_light_mana_overlord_damage"	"每次间隔的伤害："
"[english]DOTA_Tooltip_ability_keeper_of_the_light_mana_overlord_damage"	"DAMAGE PER INTERVAL:"
"DOTA_Tooltip_ability_keeper_of_the_light_mana_overlord_think_interval"	"间隔："
"[english]DOTA_Tooltip_ability_keeper_of_the_light_mana_overlord_think_interval"	"INTERVAL:"
"DOTA_Tooltip_ability_keeper_of_the_light_mana_overlord_explode_damage"	"爆炸伤害："
"[english]DOTA_Tooltip_ability_keeper_of_the_light_mana_overlord_explode_damage"	"EXPLODE DAMAGE:"
"DOTA_Tooltip_ability_keeper_of_the_light_mana_overlord_explode_radius"	"爆炸作用范围："
"[english]DOTA_Tooltip_ability_keeper_of_the_light_mana_overlord_explode_radius"	"EXPLODE RADIUS:"
"DOTA_Tooltip_ability_holdout_arc_lightning"	"弧形闪电"
"[english]DOTA_Tooltip_ability_holdout_arc_lightning"	"Arc Lightning"
"DOTA_Tooltip_ability_holdout_arc_lightning_Description"	"释放一道会跳跃穿越附近敌人的闪电。"
"[english]DOTA_Tooltip_ability_holdout_arc_lightning_Description"	"Hurls a bolt of lightning that leaps through nearby enemy units."
"DOTA_Tooltip_ability_holdout_arc_lightning_Lore"	"弧形闪电是宙斯在对付渺小的凡人时最喜欢用的法术。"
"[english]DOTA_Tooltip_ability_holdout_arc_lightning_Lore"	"Arc Lightning is Zeus' favorite spell to use against puny mortals."
"DOTA_Tooltip_ability_holdout_arc_lightning_jump_count"	"跳跃次数："
"[english]DOTA_Tooltip_ability_holdout_arc_lightning_jump_count"	"JUMPS:"
"DOTA_Tooltip_ability_holdout_lightning_bolt"	"雷击"
"[english]DOTA_Tooltip_ability_holdout_lightning_bolt"	"Lightning Bolt"
"DOTA_Tooltip_ability_holdout_lightning_bolt_Description"	"召唤一道闪电打击一个敌方单位，造成伤害及短暂眩晕。雷击在目标周围900范围内提供真实视域。"
"[english]DOTA_Tooltip_ability_holdout_lightning_bolt_Description"	"Summons a bolt of lightning to strike an enemy unit, causing damage and a mini-stun. Lightning Bolt also provides True Sight around the target in a radius of 900."
"DOTA_Tooltip_ability_holdout_lightning_bolt_Lore"	"对那些反叛的异教徒最震慑的天罚。"
"[english]DOTA_Tooltip_ability_holdout_lightning_bolt_Lore"	"A shocking punishment for rebellious heathen."
"DOTA_Tooltip_ability_holdout_lightning_bolt_Note0"	"该技能可以打断持续施法类技能和物品。"
"[english]DOTA_Tooltip_ability_holdout_lightning_bolt_Note0"	"You can interrupt channeling spells and items with this ability."
"DOTA_Tooltip_ability_holdout_static_field"	"静电场"
"[english]DOTA_Tooltip_ability_holdout_static_field"	"Static Field"
"DOTA_Tooltip_ability_holdout_static_field_Description"	"宙斯每次施放技能时都会电击附近所有敌方单位，造成他们当前生命一定比例的伤害。"
"[english]DOTA_Tooltip_ability_holdout_static_field_Description"	"Zeus shocks all nearby enemy units whenever he casts a spell, causing damage proportional to their current health."
"DOTA_Tooltip_ability_holdout_static_field_Lore"	"当天神行于世间，空气中满是静电爆裂。"
"[english]DOTA_Tooltip_ability_holdout_static_field_Lore"	"The air crackles with static when the Thundergod walks the world."
"DOTA_Tooltip_ability_holdout_static_field_Note0"	"静电场造成的伤害要先于当时使用的技能所造成的伤害。"
"[english]DOTA_Tooltip_ability_holdout_static_field_Note0"	"The damage from Static Field is dealt before the damage from the used spell."
"DOTA_Tooltip_ability_holdout_static_field_Note1"	"使用物品不能触发静电场。"
"[english]DOTA_Tooltip_ability_holdout_static_field_Note1"	"Using items doesn't trigger Static Field."
"DOTA_Tooltip_ability_holdout_static_field_Note2"	"静电场的作用效果无需己方视野。"
"[english]DOTA_Tooltip_ability_holdout_static_field_Note2"	"Does not require unit visibility to take effect."
"DOTA_Tooltip_ability_holdout_static_field_damage_health_pct"	"%生命减少："
"[english]DOTA_Tooltip_ability_holdout_static_field_damage_health_pct"	"%HEALTH REDUCTION:"
"DOTA_Tooltip_ability_holdout_static_field_radius"	"距离："
"[english]DOTA_Tooltip_ability_holdout_static_field_radius"	"RANGE:"
"DOTA_Tooltip_ability_zuus_thundergods_vengeance"	"雷神的复仇"
"[english]DOTA_Tooltip_ability_zuus_thundergods_vengeance"	"Thundergod's Vengeance"
"DOTA_Tooltip_ability_zuus_thundergods_vengeance_Description"	"对宙斯附近大片范围内的%num_targets%个敌方单位施放雷击，对施放单位的选择基于他的当前血量。雷神的复仇在每次施放时都会提供作用单位周围的真实视域。如果敌方单位处于隐身状态则不会受到伤害，但是所在地点依然会创造一片真实视域。\n\n可用神杖升级。"
"[english]DOTA_Tooltip_ability_zuus_thundergods_vengeance_Description"	"Strikes %num_targets% enemy units with a bolt of lightning, within a large range around Zeus, prioritized based upon current health.  Thundergod's Vengeance also provides True Sight around each unit struck.  If an enemy unit is invisible, it takes no damage, but the True Sight is still created at that unit's location.\n\nUpgradable by Aghanim's Scepter."
"DOTA_Tooltip_ability_zuus_thundergods_vengeance_Lore"	"神王毁灭一切胆敢反抗他的敌人，他们无所遁形。"
"[english]DOTA_Tooltip_ability_zuus_thundergods_vengeance_Lore"	"The Lord of Heaven smites all who oppose him, near or far."
"DOTA_Tooltip_ability_zuus_thundergods_vengeance_damage"	"伤害："
"[english]DOTA_Tooltip_ability_zuus_thundergods_vengeance_damage"	"DAMAGE:"
"DOTA_Tooltip_ability_zuus_thundergods_vengeance_damage_scepter"	"神杖升级伤害："
"[english]DOTA_Tooltip_ability_zuus_thundergods_vengeance_damage_scepter"	"SCEPTER DAMAGE:"
"DOTA_Tooltip_ability_zuus_thundergods_vengeance_true_sight_radius"	"真视范围："
"[english]DOTA_Tooltip_ability_zuus_thundergods_vengeance_true_sight_radius"	"TRUE SIGHT RADIUS:"
"DOTA_Tooltip_ability_zuus_thundergods_vengeance_sight_duration"	"持续时间："
"[english]DOTA_Tooltip_ability_zuus_thundergods_vengeance_sight_duration"	"DURATION:"
"DOTA_Tooltip_ability_zuus_thundergods_vengeance_aghanim_description"	"提高伤害。"
"[english]DOTA_Tooltip_ability_zuus_thundergods_vengeance_aghanim_description"	"Increases damage."
"DOTA_Tooltip_ability_holdout_stifling_dagger"	"窒碍短匕"
"[english]DOTA_Tooltip_ability_holdout_stifling_dagger"	"Stifling Dagger"
"DOTA_Tooltip_ability_holdout_stifling_dagger_Description"	"造成较低的纯粹伤害并使敌方单位减速。对英雄造成的伤害减半。"
"[english]DOTA_Tooltip_ability_holdout_stifling_dagger_Description"	"Deals minor pure damage and slows the enemy unit's movement speed. Deals half damage to heroes."
"DOTA_Tooltip_ability_holdout_stifling_dagger_Lore"	"魅影之纱成员学习到的第一个技能，中招就意味着下一次攻击要来了。"
"[english]DOTA_Tooltip_ability_holdout_stifling_dagger_Lore"	"The first skill learned by the Sisters of the Veil often signals an incoming hit."
"DOTA_Tooltip_ability_holdout_stifling_dagger_Note0"	"窒碍短匕无法被躲避。"
"[english]DOTA_Tooltip_ability_holdout_stifling_dagger_Note0"	"Stifling Dagger cannot be disjointed."
"DOTA_Tooltip_ability_holdout_stifling_dagger_move_slow"	"%移动速度减缓："
"[english]DOTA_Tooltip_ability_holdout_stifling_dagger_move_slow"	"%SLOW:"
"DOTA_Tooltip_ability_holdout_stifling_dagger_duration"	"持续时间："
"[english]DOTA_Tooltip_ability_holdout_stifling_dagger_duration"	"DURATION:"
"DOTA_Tooltip_ability_holdout_phantom_strike"	"幻影突袭"
"[english]DOTA_Tooltip_ability_holdout_phantom_strike"	"Phantom Strike"
"DOTA_Tooltip_ability_holdout_phantom_strike_Description"	"传送到一个单位身旁，敌我皆可，如果目标是敌方单位将进行攻击并获得攻速加成。"
"[english]DOTA_Tooltip_ability_holdout_phantom_strike_Description"	"Teleports to a unit, friendly or enemy, and grants bonus attack speed while attacking if it's an enemy unit."
"DOTA_Tooltip_ability_holdout_phantom_strike_Lore"	"莫崔蒂的丝绸面纱是她不幸的目标临终所见之物。"
"[english]DOTA_Tooltip_ability_holdout_phantom_strike_Lore"	"Mortred's silken veil is the last thing her unfortunate target sees."
"DOTA_Tooltip_ability_holdout_phantom_strike_bonus_max_attack_count"	"最多攻击次数："
"[english]DOTA_Tooltip_ability_holdout_phantom_strike_bonus_max_attack_count"	"MAX ATTACKS:"
"DOTA_Tooltip_ability_holdout_phantom_strike_bonus_attack_speed"	"攻击速度提升："
"[english]DOTA_Tooltip_ability_holdout_phantom_strike_bonus_attack_speed"	"BONUS ATTACK SPEED:"
"DOTA_Tooltip_ability_holdout_phantom_strike_tooltip_range"	"距离："
"[english]DOTA_Tooltip_ability_holdout_phantom_strike_tooltip_range"	"RANGE:"
"DOTA_Tooltip_ability_holdout_blur"	"魅影无形"
"[english]DOTA_Tooltip_ability_holdout_blur"	"Blur"
"DOTA_Tooltip_ability_holdout_blur_Description"	"当接近敌方英雄时，幻影刺客的身形变得模糊从而难以看清。部分敌人的攻击不能命中。"
"[english]DOTA_Tooltip_ability_holdout_blur_Description"	"The Phantom Assassin becomes hard to see by blurring her body and disappearing from the enemy minimap when near enemy heroes. Some enemy attacks miss."
"DOTA_Tooltip_ability_holdout_blur_Lore"	"长期的冥想使得魅影之纱的成员能够谨慎的预知到敌人的到来。"
"[english]DOTA_Tooltip_ability_holdout_blur_Lore"	"Meditation allows a Veiled Sister to carefully anticipate her opponents in combat."
"DOTA_Tooltip_ability_holdout_blue_Note0"	"不能与其他闪避效果叠加。"
"[english]DOTA_Tooltip_ability_holdout_blue_Note0"	"Doesn't stack with other sources of evasion."
"DOTA_Tooltip_ability_holdout_blue_Note1"	"敌方英雄处于隐身状态则不会触发技能。"
"[english]DOTA_Tooltip_ability_holdout_blue_Note1"	"Doesn't trigger from invisible heroes."
"DOTA_Tooltip_ability_holdout_blur_bonus_evasion"	"%闪避几率:"
"[english]DOTA_Tooltip_ability_holdout_blur_bonus_evasion"	"%EVASION:"
"DOTA_Tooltip_ability_holdout_blur_radius"	"作用范围："
"[english]DOTA_Tooltip_ability_holdout_blur_radius"	"RADIUS:"
"DOTA_Tooltip_ability_holdout_coup_de_grace"	"恩赐解脱"
"[english]DOTA_Tooltip_ability_holdout_coup_de_grace"	"Coup de Grace"
"DOTA_Tooltip_ability_holdout_coup_de_grace_Description"	"幻影刺客修炼她的战斗技巧，有一定概率对敌方单位造成毁灭性的致命一击。幻影刺客还可以激活恩赐解脱，使她下一次攻击必定触发暴击。"
"[english]DOTA_Tooltip_ability_holdout_coup_de_grace_Description"	"Phantom Assassin refines her combat abilities, gaining a chance of delivering a devastating critical strike that cleaves through enemy units.  Phantom Assassin can also activate Coup de Grace to get a guaranteed critical strike on the next attack."
"DOTA_Tooltip_ability_holdout_coup_de_grace_Lore"	"神圣的一击，茉崔蒂通过赐予对手死亡来向他们致以敬意。"
"[english]DOTA_Tooltip_ability_holdout_coup_de_grace_Lore"	"A divine strike, Mortred honors her opponent by choosing them for death."
"DOTA_Tooltip_ability_holdout_coup_de_grace_crit_chance"	"%致命一击概率："
"[english]DOTA_Tooltip_ability_holdout_coup_de_grace_crit_chance"	"%CRITICAL CHANCE:"
"DOTA_Tooltip_ability_holdout_coup_de_grace_crit_bonus"	"%致命一击伤害："
"[english]DOTA_Tooltip_ability_holdout_coup_de_grace_crit_bonus"	"%CRITICAL DAMAGE:"
"DOTA_Tooltip_ability_holdout_coup_de_grace_crit_radius"	"分裂范围："
"[english]DOTA_Tooltip_ability_holdout_coup_de_grace_crit_radius"	"CLEAVE RADIUS:"
"DOTA_Tooltip_ability_holdout_coup_de_grace_crit_cleave_damage"	"%分裂伤害："
"[english]DOTA_Tooltip_ability_holdout_coup_de_grace_crit_cleave_damage"	"%CLEAVE DAMAGE:"
"DOTA_Tooltip_ability_axe_battle_rage"	"战斗狂怒"
"[english]DOTA_Tooltip_ability_axe_battle_rage"	"Battle Rage"
"DOTA_Tooltip_ability_axe_battle_rage_Description"	"<font color='#70EA72'>使目标队友陷入战斗狂怒状态。在其影响下，所有攻击都带有吸血效果。</font>"
"[english]DOTA_Tooltip_ability_axe_battle_rage_Description"	"<font color='#70EA72'>Sends target allied unit into a Battle Rage. When affected by Battle Rage, all damage dealt by that unit steals life.</font>"
"DOTA_Tooltip_ability_axe_battle_rage_Lore"	"蒙哥可汗的狂怒伴他度过残忍和毁灭的可怕行径。"
"[english]DOTA_Tooltip_ability_axe_battle_rage_Lore"	"Mogul Khan's rage propels him through terrifying acts of brutality and destruction."
"DOTA_Tooltip_ability_axe_battle_rage_duration"	"<font color='#70EA72'>持续时间：</font>"
"[english]DOTA_Tooltip_ability_axe_battle_rage_duration"	"<font color='#70EA72'>DURATION:</font>"
"DOTA_Tooltip_ability_axe_battle_rage_heal_multiplier"	"%<font color='#70EA72'>吸血效果：</font>"
"[english]DOTA_Tooltip_ability_axe_battle_rage_heal_multiplier"	"%<font color='#70EA72'>LIFESTEAL:</font>"
"DOTA_Tooltip_axe_battle_rage_modifier"	"战斗饥渴"
"[english]DOTA_Tooltip_axe_battle_rage_modifier"	"Battle Hunger"
"DOTA_Tooltip_axe_battle_rage_modifier_Description"	"对战斗的饥渴使其在造成伤害的同时窃取生命。"
"[english]DOTA_Tooltip_axe_battle_rage_modifier_Description"	"The hunger of battle steals life on damage dealt."
"DOTA_Tooltip_ability_holdout_shackleshot"	"束缚击"
"[english]DOTA_Tooltip_ability_holdout_shackleshot"	"Shackleshot"
"DOTA_Tooltip_ability_holdout_shackleshot_Description"	"将目标束缚在正对其后的一个敌方单位或树上。若目标后面没有其它敌方单位或树木，则眩晕时间减少至0.75秒。<font color='#70EA72'>如果束缚击成功束缚到后方单位，那么束缚效果将向后弹跳，除非达到最大束缚次数或作用单位后方没有单位或树木。</font>"
"[english]DOTA_Tooltip_ability_holdout_shackleshot_Description"	"Shackles the target to enemy units or a tree in a line directly behind it.  If no unit or tree is present, the stun duration is reduced to 0.75.  <font color='#70EA72'>If a shackle is made to a second unit, the shackle will bounce and continue behind that unit, until the max count is reached or no unit or tree is found.</font>"
"DOTA_Tooltip_ability_holdout_shackleshot_Lore"	"风行者的诸多弓技中，有一种用密集的绳索来束缚住敌人让其难以逃脱的箭矢。"
"[english]DOTA_Tooltip_ability_holdout_shackleshot_Lore"	"Windranger's variety of bow skills includes an arrow with thick ropes attached to encumber any escaping target."
"DOTA_Tooltip_ability_holdout_shackleshot_shackle_count"	"<font color='#70EA72'>束缚次数：</font>"
"[english]DOTA_Tooltip_ability_holdout_shackleshot_shackle_count"	"<font color='#70EA72'>SHACKLE COUNT:</font>"
"DOTA_Tooltip_ability_holdout_shackleshot_Note0"	"该技能可以将两个敌人一起束缚，使他们同时眩晕。"
"[english]DOTA_Tooltip_ability_holdout_shackleshot_Note0"	"This spell can shackle two enemies together, stunning them both."
"DOTA_Tooltip_ability_holdout_shackleshot_Note1"	"束缚击能将目标束缚在身后最多距离525码的敌方单位或500码的树木。"
"[english]DOTA_Tooltip_ability_holdout_shackleshot_Note1"	"Can shackle the target to an enemy unit or tree at most 525/500 behind it."
"DOTA_Tooltip_ability_holdout_shackleshot_Note2"	"束缚击无法被躲避。"
"[english]DOTA_Tooltip_ability_holdout_shackleshot_Note2"	"Shackleshot cannot be disjointed."
"DOTA_Tooltip_ability_holdout_shackleshot_stun_duration"	"<font color='#70EA72'>束缚击持续时间：</font>"
"[english]DOTA_Tooltip_ability_holdout_shackleshot_stun_duration"	"<font color='#70EA72'>SHACKLE DURATION:</font>"
"DOTA_Tooltip_ability_holdout_windrun"	"风行"
"[english]DOTA_Tooltip_ability_holdout_windrun"	"Windrun"
"DOTA_Tooltip_ability_holdout_windrun_Description"	"提升移动速度并闪避一切物理攻击，同时降低周围敌人的移动速度。"
"[english]DOTA_Tooltip_ability_holdout_windrun_Description"	"Increases movement speed and adds evasion from all physical attacks, while slowing movement of nearby enemies."
"DOTA_Tooltip_ability_holdout_windrun_Lore"	"名副其实，莱瑞蕾用疾风之力进行防御。"
"[english]DOTA_Tooltip_ability_holdout_windrun_Lore"	"True to her namesake, Lyralei enchants gusts of winds to flight incoming attacks."
"DOTA_Tooltip_ability_holdout_windrun_Note0"	"减速效果无视魔法免疫。"
"[english]DOTA_Tooltip_ability_holdout_windrun_Note0"	"The slow will affect enemies with magic immunity."
"DOTA_Tooltip_ability_holdout_windrun_Note1"	"风行不能躲避在开启技能前产生的攻击和技能弹道。"
"[english]DOTA_Tooltip_ability_holdout_windrun_Note1"	"Windrun will not evade projectiles that were created before it was activated."
"DOTA_Tooltip_ability_holdout_windrun_enemy_movespeed_bonus_pct"	"%<font color='#70EA72'>对敌减速：</font>"
"[english]DOTA_Tooltip_ability_holdout_windrun_enemy_movespeed_bonus_pct"	"%<font color='#70EA72'>ENEMY SLOW:</font>"
"DOTA_Tooltip_ability_holdout_windrun_movespeed_bonus_pct"	"%移动速度加成："
"[english]DOTA_Tooltip_ability_holdout_windrun_movespeed_bonus_pct"	"%MOVE SPEED BONUS:"
"DOTA_Tooltip_ability_holdout_windrun_duration"	"<font color='#70EA72'>持续时间：</font>"
"[english]DOTA_Tooltip_ability_holdout_windrun_duration"	"<font color='#70EA72'>DURATION:</font>"
"DOTA_Tooltip_ability_holdout_windrun_radius"	"<font color='#70EA72'>作用范围：</font>"
"[english]DOTA_Tooltip_ability_holdout_windrun_radius"	"<font color='#70EA72'>RADIUS:</font>"
"DOTA_Tooltip_ability_holdout_focusfire"	"西风"
"[english]DOTA_Tooltip_ability_holdout_focusfire"	"Zephyr"
"DOTA_Tooltip_ability_holdout_focusfire_Description"	"风行者受风的引领，以最大攻击速度对敌方单位进行攻击，但攻击伤害降低，从独占攻效和物品效果中获得的伤害也降低。<font color='#70EA72'>每一次攻击风行者都有几率在攻击目标的一定范围内对一个目标额外射一支箭。持续20秒。</font>"
"[english]DOTA_Tooltip_ability_holdout_focusfire_Description"	"Windranger channels the wind, gaining maximum attack speed, although with reduced damage, including damage from Unique Attack Modifiers and item effects. <font color='#70EA72'>With each attack, Windranger has a chance to fire an additional arrow at a target within a radius of the attacked unit. Lasts 20 seconds.</font>"
"DOTA_Tooltip_ability_holdout_focusfire_Lore"	"莱瑞蕾具备狂风般地向敌人轰射出无数箭矢的无双本领——即便牺牲了不少威力。"
"[english]DOTA_Tooltip_ability_holdout_focusfire_Lore"	"Lyralei's ability to bombard opponents with a flurry of arrows is unparalleled - even at the expense of accuracy."
"DOTA_Tooltip_ability_holdout_focusfire_Note0"	"能够以建筑和魔法免疫单位为目标。"
"[english]DOTA_Tooltip_ability_holdout_focusfire_Note0"	"Can target buildings and magic immune units."
"DOTA_Tooltip_ability_holdout_focusfire_focusfire_damage_reduction"	"%基础攻击力降低："
"[english]DOTA_Tooltip_ability_holdout_focusfire_focusfire_damage_reduction"	"%DAMAGE REDUCTION:"
"DOTA_Tooltip_ability_holdout_focusfire_bonus_arrow_chance"	"%<font color='#70EA72'>额外射箭几率：</font>"
"[english]DOTA_Tooltip_ability_holdout_focusfire_bonus_arrow_chance"	"%<font color='#70EA72'>BONUS ARROW CHANCE:</font>"
"DOTA_Tooltip_ability_holdout_focusfire_bonus_arrow_radius"	"<font color='#70EA72'>额外射箭范围：</font>"
"[english]DOTA_Tooltip_ability_holdout_focusfire_bonus_arrow_radius"	"<font color='#70EA72'>BONUS ARROW RADIUS:</font>"
"DOTA_Tooltip_ability_holdout_focusfire_bonus_arrows"	"<font color='#70EA72'>额外箭矢数量：</font>"
"[english]DOTA_Tooltip_ability_holdout_focusfire_bonus_arrows"	"<font color='#70EA72'>BONUS ARROWS:</font>"
"DOTA_Tooltip_ability_dark_seer_wall_of_discord"	"纷争之墙"
"[english]DOTA_Tooltip_ability_dark_seer_wall_of_discord"	"Wall of Discord"
"DOTA_Tooltip_ability_dark_seer_wall_of_discord_Description"	"制造一堵扭曲的光墙，对所有穿过的敌方单位造成伤害。"
"[english]DOTA_Tooltip_ability_dark_seer_wall_of_discord_Description"	"Raises a wall of warping light that damages any enemy unit who crosses it."
"DOTA_Tooltip_ability_dark_seer_wall_of_discord_Lore"	"尽管黑暗贤者不能回到他原来的国度，他仍然能召唤出一道具有强大心智力量的璀璨幻墙，在敌人之间制造混乱。"
"[english]DOTA_Tooltip_ability_dark_seer_wall_of_discord_Lore"	"The Dark Seer, while unable to return to his natural realm, can channel part of the prismatic wall with powerful strength of mind, sowing destruction amongst enemy ranks."
"DOTA_Tooltip_ability_dark_seer_wall_of_discord_Note1"	"创造1000码长的光墙，光墙垂直于黑暗贤者和目标点的连线。"
"[english]DOTA_Tooltip_ability_dark_seer_wall_of_discord_Note1"	"Creates a wall 1000 units long, perpendicular to the line between Dark Seer and the target point."
"DOTA_Tooltip_ability_dark_seer_wall_of_discord_damage"	"伤害："
"[english]DOTA_Tooltip_ability_dark_seer_wall_of_discord_damage"	"DAMAGE:"
"DOTA_Tooltip_ability_dark_seer_wall_of_discord_duration"	"持续时间："
"[english]DOTA_Tooltip_ability_dark_seer_wall_of_discord_duration"	"DURATION:"
"DOTA_Tooltip_modifier_dark_seer_wall_of_discord_target"	"纷争之墙"
"[english]DOTA_Tooltip_modifier_dark_seer_wall_of_discord_target"	"Wall of Discord"
"DOTA_Tooltip_modifier_dark_seer_wall_of_discord_target_Description"	"被黑暗贤者的纷争之墙所干扰。"
"[english]DOTA_Tooltip_modifier_dark_seer_wall_of_discord_target_Description"	"Has been disrupted by Dark Seer's Wall of Discord."
"DOTA_Tooltip_ability_magnataur_skewer_holdout"	"巨角冲撞"
"[english]DOTA_Tooltip_ability_magnataur_skewer_holdout"	"Skewer"
"DOTA_Tooltip_ability_magnataur_skewer_holdout_Description"	"马格纳斯向前冲刺，用他巨大的犀角顶起敌方单位。途中碰到<font color='#70EA72'>非英雄单位</font>会将其拖拽到目的地，再造成伤害和减速。"
"[english]DOTA_Tooltip_ability_magnataur_skewer_holdout_Description"	"Magnus rushes forward, goring enemy units on his massive tusk.  <font color='#70EA72'>Creeps</font> hit on the way will be dragged to the destination, then damaged and slowed."
"DOTA_Tooltip_ability_magnataur_skewer_holdout_Lore"	"对潜在的商人来说，半人犀牛的犀角价值与犀角能够造成的破坏成正比。"
"[english]DOTA_Tooltip_ability_magnataur_skewer_holdout_Lore"	"Magnoceros horns are valuable in direct proportion to their danger to prospective merchants."
"DOTA_Tooltip_ability_magnataur_skewer_holdout_range"	"距离："
"[english]DOTA_Tooltip_ability_magnataur_skewer_holdout_range"	"DISTANCE:"
"DOTA_Tooltip_ability_magnataur_skewer_holdout_skewer_speed"	"速度："
"[english]DOTA_Tooltip_ability_magnataur_skewer_holdout_skewer_speed"	"SPEED:"
"DOTA_Tooltip_ability_magnataur_skewer_holdout_max_targets"	"<font color='#70EA72'>最多目标数：</font>"
"[english]DOTA_Tooltip_ability_magnataur_skewer_holdout_max_targets"	"<font color='#70EA72'>MAX TARGETS:</font>"
"DOTA_Tooltip_ability_magnataur_skewer_holdout_slow_duration"	"减速持续时间："
"[english]DOTA_Tooltip_ability_magnataur_skewer_holdout_slow_duration"	"SLOW DURATION:"
"DOTA_Tooltip_ability_magnataur_skewer_holdout_slow_pct"	"%移动速度减缓："
"[english]DOTA_Tooltip_ability_magnataur_skewer_holdout_slow_pct"	"%SLOW:"
"DOTA_Tooltip_ability_magnataur_skewer_holdout_skewer_damage"	"伤害："
"[english]DOTA_Tooltip_ability_magnataur_skewer_holdout_skewer_damage"	"DAMAGE:"
"DOTA_Tooltip_ability_mirana_moonfall"	"暗月坠落"
"[english]DOTA_Tooltip_ability_mirana_moonfall"	"Moonfall"
"DOTA_Tooltip_ability_mirana_moonfall_Description"	"召唤月亮砸向大片范围内的敌方单位，造成伤害和眩晕"
"[english]DOTA_Tooltip_ability_mirana_moonfall_Description"	"Calls down a chunk of the moon to damage and stun enemies in a large radius."
"DOTA_Tooltip_ability_mirana_moonfall_Lore"	"女神代表她忠心的仆从进行干预，苍穹和大地为之颤栗。"
"[english]DOTA_Tooltip_ability_mirana_moonfall_Lore"	"The Goddess' intervention on behalf of her loyal servant shakes the heavens and earth."
"DOTA_Tooltip_ability_mirana_moonfall_radius"	"作用范围："
"[english]DOTA_Tooltip_ability_mirana_moonfall_radius"	"RADIUS:"
"DOTA_Tooltip_ability_holdout_mirana_arrow"	"月神之箭"
"[english]DOTA_Tooltip_ability_holdout_mirana_arrow"	"Sacred Arrow"
"DOTA_Tooltip_ability_holdout_mirana_arrow_description"	"射出一支绝对精准的箭矢，对第一个击中的敌人造成大量伤害并眩晕目标。目标距离越远，眩晕时间越长，最短0.5秒，最多5秒。基于距离还将对目标额外造成最多100点伤害。"
"[english]DOTA_Tooltip_ability_holdout_mirana_arrow_description"	"Fires an arrow with deadly precision, dealing large damage and stunning the first enemy unit it strikes. Stun duration increases based on distance to target, ranging from 0.5 to 5 seconds. Bonus damage up to 100 is applied based on distance to target."
"DOTA_Tooltip_ability_holdout_mirana_arrow_Lore"	"月之能量让月之公主的箭矢变得更致命。"
"[english]DOTA_Tooltip_ability_holdout_mirana_arrow_Lore"	"Lunar energies make the Princess of the Moon's arrows more deadly than most."
"DOTA_Tooltip_ability_holdout_mirana_arrow_Note0"	"神箭每飞行150码，中箭后眩晕的持续时间将提高0.5秒。"
"[english]DOTA_Tooltip_ability_holdout_mirana_arrow_Note0"	"For every 150 distance the arrow travels, the stun duration upon impact increases by 0.5 seconds."
"DOTA_Tooltip_ability_holdout_mirana_arrow_Note1"	"月神之箭可以伤害隐身单位，但是只造成伤害；不会产生眩晕效果。"
"[english]DOTA_Tooltip_ability_holdout_mirana_arrow_Note1"	"Sacred Arrow hits invisible units, but only deals damage; no stun is applied."
"DOTA_Tooltip_ability_holdout_mirana_arrow_arrow_range"	"距离："
"[english]DOTA_Tooltip_ability_holdout_mirana_arrow_arrow_range"	"RANGE:"
"DOTA_Tooltip_ability_holdout_mirana_arrow_arrow_min_stun"	"最短眩晕："
"[english]DOTA_Tooltip_ability_holdout_mirana_arrow_arrow_min_stun"	"MINIMUM STUN:"
"DOTA_Tooltip_ability_holdout_mirana_arrow_arrow_max_stun"	"最长眩晕："
"[english]DOTA_Tooltip_ability_holdout_mirana_arrow_arrow_max_stun"	"MAXIMUM STUN:"
"DOTA_Tooltip_ability_holdout_mirana_arrow_bonus_damage"	"额外伤害："
"[english]DOTA_Tooltip_ability_holdout_mirana_arrow_bonus_damage"	"BONUS DAMAGE:"
"DOTA_Tooltip_ability_holdout_purification"	"洗礼"
"[english]DOTA_Tooltip_ability_holdout_purification"	"Purification"
"DOTA_Tooltip_ability_holdout_purification_Description"	"立刻治疗一名友方单位并对周围所有敌方单位造成伤害。"
"[english]DOTA_Tooltip_ability_holdout_purification_Description"	"Instantly heals a friendly unit and damages all nearby enemy units."
"DOTA_Tooltip_ability_holdout_purification_Lore"	"全知的牧师们善于清除己方战士们身心中的污杂。"
"[english]DOTA_Tooltip_ability_holdout_purification_Lore"	"Priests of the Omniscience are adept at removing impurities from fellow warriors."
"DOTA_Tooltip_ability_holdout_purification_heal"	"治疗量/伤害量："
"[english]DOTA_Tooltip_ability_holdout_purification_heal"	"HEAL/DAMAGE:"
"DOTA_Tooltip_ability_holdout_purification_radius"	"作用范围："
"[english]DOTA_Tooltip_ability_holdout_purification_radius"	"RADIUS:"
"DOTA_Tooltip_ability_holdout_purification_notes"	"备注：\n\n无法选择驱逐状态下队友做目标。"
"[english]DOTA_Tooltip_ability_holdout_purification_notes"	"Notes:\n\nRepelled allies cannot be targeted."
"DOTA_Tooltip_ability_holdout_degen_aura"	"退化光环"
"[english]DOTA_Tooltip_ability_holdout_degen_aura"	"Degen Aura"
"DOTA_Tooltip_ability_holdout_degen_aura_Description"	"极大程度的减缓附近敌人的移动速度和攻击速度。"
"[english]DOTA_Tooltip_ability_holdout_degen_aura_Description"	"Greatly degenerates the movement and attack capabilities of enemy units that stray too near."
"DOTA_Tooltip_ability_holdout_degen_aura_Lore"	"作为神圣的化身，普里斯特．雷霆之怒足以削弱那些不忠之徒。"
"[english]DOTA_Tooltip_ability_holdout_degen_aura_Lore"	"The holy embodiment of Purist Thunderwrath is enough to weaken those of lesser faith."
"DOTA_Tooltip_ability_holdout_degen_aura_radius"	"<font color='#70EA72'>作用范围：</font>"
"[english]DOTA_Tooltip_ability_holdout_degen_aura_radius"	"<font color='#70EA72'>RADIUS:</font>"
"DOTA_Tooltip_ability_holdout_degen_aura_speed_bonus"	"%移动/攻击速度降低："
"[english]DOTA_Tooltip_ability_holdout_degen_aura_speed_bonus"	"%MOVE/ATTACK SLOW:"
"DOTA_Tooltip_ability_holdout_degen_aura_notes"	"备注：\n\n光环的作用范围非常小。"
"[english]DOTA_Tooltip_ability_holdout_degen_aura_notes"	"Notes:\n\nExceptionally small area of effect for an aura."
"DOTA_Tooltip_ability_holdout_guardian_angel"	"全能之翼"
"[english]DOTA_Tooltip_ability_holdout_guardian_angel"	"Wings of Omniscience"
"DOTA_Tooltip_ability_holdout_guardian_angel_Description"	"<font color='#70EA72'>全能骑士召唤出守护天使，使附近的友方单位对物理伤害免疫，并极大地提高生命回复速率。守护天使会自动攻击附近的敌方单位，而且不受玩家控制。</font>"
"[english]DOTA_Tooltip_ability_holdout_guardian_angel_Description"	"<font color='#70EA72'>Omniknight summons Guardian Angels that grants immunity from physical damage and greatly increases hit point regeneration of nearby allies.  The Guardian Angels will fight enemy units nearby, but cannot be controlled by any player.</font>"
"DOTA_Tooltip_ability_holdout_guardian_angel_Lore"	"全知之主对那些被普利斯特称为“朋友”的人降下保护结界。"
"[english]DOTA_Tooltip_ability_holdout_guardian_angel_Lore"	"The All Seeing One casts down his protection over those that Purist calls friend."
"DOTA_Tooltip_ability_holdout_guardian_angel_Note0"	"效果无视魔法免疫。"
"[english]DOTA_Tooltip_ability_holdout_guardian_angel_Note0"	"Affects allies with magic immunity."
"DOTA_Tooltip_ability_holdout_guardian_angel_Note1"	"可以被净化。"
"[english]DOTA_Tooltip_ability_holdout_guardian_angel_Note1"	"Can be purged."
"DOTA_Tooltip_ability_holdout_guardian_angel_duration"	"持续时间："
"[english]DOTA_Tooltip_ability_holdout_guardian_angel_duration"	"DURATION:"
"DOTA_Tooltip_ability_holdout_guardian_angel_health_regen"	"生命回复提升："
"[english]DOTA_Tooltip_ability_holdout_guardian_angel_health_regen"	"HEALTH REGEN:"
"DOTA_Tooltip_ability_holdout_guardian_angel_radius"	"作用范围："
"[english]DOTA_Tooltip_ability_holdout_guardian_angel_radius"	"RADIUS:"
"DOTA_Tooltip_ability_holdout_guardian_angel_angel_damage"	"<font color='#70EA72'>天使攻击力：</font>"
"[english]DOTA_Tooltip_ability_holdout_guardian_angel_angel_damage"	"<font color='#70EA72'>ANGEL DAMAGE:</font>"
"DOTA_Tooltip_ability_holdout_guardian_angel_notes"	"备注：\n\n魔免状态下队友也将受到作用。"
"[english]DOTA_Tooltip_ability_holdout_guardian_angel_notes"	"Notes:\n\nAffects allies with Magic Immunity."
"DOTA_Tooltip_modifier_holdout_guardian_angel_buff"	"全能之翼"
"[english]DOTA_Tooltip_modifier_holdout_guardian_angel_buff"	"Wings of Omniscience"
"DOTA_Tooltip_modifier_holdout_guardian_angel_buff_Description"	"对物理伤害免疫，并由守护天使保护。"
"[english]DOTA_Tooltip_modifier_holdout_guardian_angel_buff_Description"	"Immune to physical damage and protected by Guardian Angel."
"DOTA_Tooltip_ability_holdout_axe_berserkers_call"	"狂战士之吼"
"[english]DOTA_Tooltip_ability_holdout_axe_berserkers_call"	"Berserker's Call"
"DOTA_Tooltip_ability_holdout_axe_berserkers_call_Description"	"斧王嘲讽附近的敌方单位，强迫他们攻击自己，同时获得额外护甲。"
"[english]DOTA_Tooltip_ability_holdout_axe_berserkers_call_Description"	"Axe taunts nearby enemy units, forcing them to attack him, while he gains bonus armor during the duration."
"DOTA_Tooltip_ability_holdout_axe_berserkers_call_Note0"	"效果无视魔法免疫。"
"[english]DOTA_Tooltip_ability_holdout_axe_berserkers_call_Note0"	"Affects units with magic immunity."
"DOTA_Tooltip_ability_holdout_axe_berserkers_call_Lore"	"蒙哥可汗的狂吼嘲讽使敌人不得不与他作战。"
"[english]DOTA_Tooltip_ability_holdout_axe_berserkers_call_Lore"	"Mogul Khan's warcry taunts opponents into engaging in an unconquerable battle with the Axe."
"DOTA_Tooltip_ability_holdout_axe_berserkers_call_radius"	"<font color='#70EA72'>作用范围：</font>"
"[english]DOTA_Tooltip_ability_holdout_axe_berserkers_call_radius"	"<font color='#70EA72'>RADIUS:</font>"
"DOTA_Tooltip_ability_holdout_axe_berserkers_call_bonus_armor"	"护甲提升："
"[english]DOTA_Tooltip_ability_holdout_axe_berserkers_call_bonus_armor"	"BONUS ARMOR:"
"DOTA_Tooltip_ability_holdout_axe_berserkers_call_duration"	"<font color='#70EA72'>持续时间：</font>"
"[english]DOTA_Tooltip_ability_holdout_axe_berserkers_call_duration"	"<font color='#70EA72'>DURATION:</font>"
"DOTA_Tooltip_ability_holdout_axe_counter_helix"	"反击螺旋"
"[english]DOTA_Tooltip_ability_holdout_axe_counter_helix"	"Counter Helix"
"DOTA_Tooltip_ability_holdout_axe_counter_helix_Description"	"受攻击时，斧王做出螺旋反击，对附近所有敌方单位造成伤害。"
"[english]DOTA_Tooltip_ability_holdout_axe_counter_helix_Description"	"When attacked, Axe performs a helix counter attack, dealing damage to all nearby enemies."
"DOTA_Tooltip_ability_holdout_axe_counter_helix_Note0"	"反击螺旋在敌人产生攻击前摇时就会计算是否触发，而不是在斧王实际受到上述伤害之后。"
"[english]DOTA_Tooltip_ability_holdout_axe_counter_helix_Note0"	"Counter Helix checks for triggering whenever an attack against Axe begins, not when Axe is actually damaged by said attack."
"DOTA_Tooltip_ability_holdout_axe_counter_helix_Lore"	"这支军队只要有斧王就不需要援军了。"
"[english]DOTA_Tooltip_ability_holdout_axe_counter_helix_Lore"	"Axe is the only reinforcement this army needs."
"DOTA_Tooltip_ability_holdout_axe_counter_helix_radius"	"作用范围："
"[english]DOTA_Tooltip_ability_holdout_axe_counter_helix_radius"	"RADIUS:"
"DOTA_Tooltip_ability_holdout_axe_counter_helix_trigger_chance"	"%反击率："
"[english]DOTA_Tooltip_ability_holdout_axe_counter_helix_trigger_chance"	"%CHANCE TO HELIX:"
"DOTA_Tooltip_ability_holdout_ether_shock"	"苍穹震击"
"[english]DOTA_Tooltip_ability_holdout_ether_shock"	"Ether Shock"
"DOTA_Tooltip_ability_holdout_ether_shock_Description"	"利用虚空能量制造出分叉的闪电，打击多个敌方单位。"
"[english]DOTA_Tooltip_ability_holdout_ether_shock_Description"	"Creates a cone of ethereal energy that strikes multiple enemy units."
"DOTA_Tooltip_ability_holdout_ether_shock_Lore"	"最初是给流浪艺人作开场秀用的，罗斯塔的闪电之炫能分成数叉来震击不止一个对手。"
"[english]DOTA_Tooltip_ability_holdout_ether_shock_Lore"	"Originally used to open shows with the travelling con-man, Rhasta's lightning display shocks adversaries in more ways than one."
"DOTA_Tooltip_ability_holdout_ether_shock_Note0"	"最远可以伤害距离1000码的次级单位。"
"[english]DOTA_Tooltip_ability_holdout_ether_shock_Note0"	"Can hit secondary targets up to 1000 distance away."
"DOTA_Tooltip_ability_holdout_ether_shock_targets"	"<font color='#70EA72'>目标数：</font>"
"[english]DOTA_Tooltip_ability_holdout_ether_shock_targets"	"<font color='#70EA72'>TARGETS:</font>"
"DOTA_Tooltip_ability_holdout_ether_shock_damage"	"<font color='#70EA72'>伤害：</font>"
"[english]DOTA_Tooltip_ability_holdout_ether_shock_damage"	"<font color='#70EA72'>DAMAGE:</font>"
"DOTA_Tooltip_ability_holdout_voodoo"	"巫术"
"[english]DOTA_Tooltip_ability_holdout_voodoo"	"Voodoo"
"DOTA_Tooltip_ability_holdout_voodoo_Description"	"将<font color='#70EA72'>敌方区域</font>内任意敌方单位变成人畜无害的动物，使其丧失攻击和使用技能的能力。"
"[english]DOTA_Tooltip_ability_holdout_voodoo_Description"	"Transforms any enemy units in the <font color='#70EA72'>target area</font> into a harmless creature, disabling their attacks and abilities."
"DOTA_Tooltip_ability_holdout_voodoo_Lore"	"罗斯塔通常将自己变成一个小鸡来结束表演——现在他把这个屈辱分享给别人了。"
"[english]DOTA_Tooltip_ability_holdout_voodoo_Lore"	"Rhasta often ended performances by turning himself into a chicken - now, the humiliation is shared."
"DOTA_Tooltip_ability_holdout_voodoo_Note0"	"立刻杀死幻象。"
"[english]DOTA_Tooltip_ability_holdout_voodoo_Note0"	"Instantly destroys illusions."
"DOTA_Tooltip_ability_holdout_voodoo_Note1"	"目标的基础移动速度为100，但是如果目标有满速状态则移速不受影响。"
"[english]DOTA_Tooltip_ability_holdout_voodoo_Note1"	"The target will have a base movement speed of 100, but buffs granting maximum movement speed won't be disabled."
"DOTA_Tooltip_ability_holdout_voodoo_Note2"	"妖术将使伤害格挡和闪避无效。"
"[english]DOTA_Tooltip_ability_holdout_voodoo_Note2"	"Hex disables damage block and evasion."
"DOTA_Tooltip_ability_holdout_voodoo_duration"	"持续时间："
"[english]DOTA_Tooltip_ability_holdout_voodoo_duration"	"DURATION:"
"DOTA_Tooltip_ability_holdout_voodoo_radius"	"<font color='#70EA72'>作用范围：</font>"
"[english]DOTA_Tooltip_ability_holdout_voodoo_radius"	"<font color='#70EA72'>RADIUS:</font>"
"DOTA_Tooltip_ability_holdout_shackles"	"枷锁"
"[english]DOTA_Tooltip_ability_holdout_shackles"	"Shackles"
"DOTA_Tooltip_ability_holdout_shackles_Description"	"持续施法 - 使用魔法绑住一个敌方单位，使其无法攻击和移动，同时持续造成伤害。"
"[english]DOTA_Tooltip_ability_holdout_shackles_Description"	"CHANNELED - Magically binds an enemy unit so that it cannot move or attack, while dealing damage over time."
"DOTA_Tooltip_ability_holdout_shackles_Lore"	"一个自卫用咒语，是师傅于渗色岭被害后，罗斯塔所开发的枷锁咒。"
"[english]DOTA_Tooltip_ability_holdout_shackles_Lore"	"A self-defense incantation, Rhasta developed shackles after his master was slain in the Bleeding Hills."
"DOTA_Tooltip_ability_holdout_shackles_channel_time"	"<font color='#70EA72'>持续施法时间：</font>"
"[english]DOTA_Tooltip_ability_holdout_shackles_channel_time"	"<font color='#70EA72'>CHANNEL DURATION:</font>"
"DOTA_Tooltip_ability_holdout_shadowraze1"	"毁灭阴影"
"[english]DOTA_Tooltip_ability_holdout_shadowraze1"	"Shadowraze"
"DOTA_Tooltip_ability_holdout_shadowraze1_Description"	"影魔对其正前方区域发出毁灭能量，对该区域中的敌人造成伤害。"
"[english]DOTA_Tooltip_ability_holdout_shadowraze1_Description"	"Shadow Fiend razes the area in front of him, dealing damage to enemy units in an area."
"DOTA_Tooltip_ability_holdout_shadowraze1_Lore"	"奈文摩尔标志性的灵魂收割手段。"
"[english]DOTA_Tooltip_ability_holdout_shadowraze1_Lore"	"Nevermore's trademark for harvesting souls."
"DOTA_Tooltip_ability_holdout_shadowraze1_shadowraze_range"	"距离："
"[english]DOTA_Tooltip_ability_holdout_shadowraze1_shadowraze_range"	"RANGE:"
"DOTA_Tooltip_ability_holdout_shadowraze2"	"毁灭阴影"
"[english]DOTA_Tooltip_ability_holdout_shadowraze2"	"Shadowraze"
"DOTA_Tooltip_ability_holdout_shadowraze2_Description"	"影魔对其正前方区域发出毁灭能量，对该区域中的敌人造成伤害。"
"[english]DOTA_Tooltip_ability_holdout_shadowraze2_Description"	"Shadow Fiend razes the area in front of him, dealing damage to enemy units in an area."
"DOTA_Tooltip_ability_holdout_shadowraze2_Lore"	"奈文摩尔标志性的灵魂收割手段。"
"[english]DOTA_Tooltip_ability_holdout_shadowraze2_Lore"	"Nevermore's trademark for harvesting souls."
"DOTA_Tooltip_ability_holdout_shadowraze2_shadowraze_range"	"距离："
"[english]DOTA_Tooltip_ability_holdout_shadowraze2_shadowraze_range"	"RANGE:"
"DOTA_Tooltip_ability_holdout_shadowraze3"	"毁灭阴影"
"[english]DOTA_Tooltip_ability_holdout_shadowraze3"	"Shadowraze"
"DOTA_Tooltip_ability_holdout_shadowraze3_Description"	"影魔对其正前方区域发出毁灭能量，对该区域中的敌人造成伤害。"
"[english]DOTA_Tooltip_ability_holdout_shadowraze3_Description"	"Shadow Fiend razes the area in front of him, dealing damage to enemy units in an area."
"DOTA_Tooltip_ability_holdout_shadowraze3_Lore"	"奈文摩尔标志性的灵魂收割手段。"
"[english]DOTA_Tooltip_ability_holdout_shadowraze3_Lore"	"Nevermore's trademark for harvesting souls."
"DOTA_Tooltip_ability_holdout_shadowraze3_shadowraze_range"	"距离："
"[english]DOTA_Tooltip_ability_holdout_shadowraze3_shadowraze_range"	"RANGE:"
"DOTA_Tooltip_ability_holdout_spell_steal"	"技能窃取"
"[english]DOTA_Tooltip_ability_holdout_spell_steal"	"Spell Steal"
"DOTA_Tooltip_ability_holdout_spell_steal_Description"	"拉比克钻研一个敌方生物的魔法精华之痕，学习这个生物最后释放的技能的秘密。拉比克将可以使用这个技能，维持几分钟或直到他死亡。\n\n可用神杖升级。"
"[english]DOTA_Tooltip_ability_holdout_spell_steal_Description"	"Rubick studies the trace magical essence of one enemy hero, learning the secrets of the last spell the target creature cast. Rubick can use this spell as his own for several minutes or until he dies.\n\nUpgradable by Aghanim's Scepter."
"DOTA_Tooltip_ability_holdout_spell_steal_Lore"	"...不过即使是他们那些低级魔法也能变得非常实用。"
"[english]DOTA_Tooltip_ability_holdout_spell_steal_Lore"	"...but even their lesser magics can be a source of much utility."
"DOTA_Tooltip_ability_holdout_spell_steal_Note0"	"无法窃取物品类技能。"
"[english]DOTA_Tooltip_ability_holdout_spell_steal_Note0"	"Cannot steal item abilities."
"DOTA_Tooltip_ability_holdout_spell_steal_duration"	"持续时间："
"[english]DOTA_Tooltip_ability_holdout_spell_steal_duration"	"DURATION:"
"DOTA_Tooltip_ability_holdout_spell_steal_cooldown_scepter"	"神杖升级冷却时间："
"[english]DOTA_Tooltip_ability_holdout_spell_steal_cooldown_scepter"	"SCEPTER COOLDOWN:"
"DOTA_Tooltip_ability_holdout_spell_steal_aghanim_description"	"减少冷却时间，提升施法距离并将窃取的技能升级为神杖升级后的效果。"
"[english]DOTA_Tooltip_ability_holdout_spell_steal_aghanim_description"	"Decreases cooldown, increases cast range and upgrades the spell to the Scepter level."
"DOTA_Tooltip_ability_holdout_gush"	"巨浪"
"[english]DOTA_Tooltip_ability_holdout_gush"	"Gush"
"DOTA_Tooltip_ability_holdout_gush_Description"	"召唤一股巨浪攻击对其路径上的所有敌方单位减速造成减速，并削弱他们的护甲。"
"[english]DOTA_Tooltip_ability_holdout_gush_Description"	"Summons a gush of water to slow and weaken the armor of enemies caught in its path."
"DOTA_Tooltip_ability_holdout_gush_Lore"	"在沉没之岛的竞赛中，利维坦赢得了对公海的统治。"
"[english]DOTA_Tooltip_ability_holdout_gush_Lore"	"During his championship of the Sunken Isles, Leviathan gained mastery over the open sea."
"DOTA_Tooltip_ability_holdout_gush_movement_speed"	"%移动速度减缓："
"[english]DOTA_Tooltip_ability_holdout_gush_movement_speed"	"%SLOW:"
"DOTA_Tooltip_ability_holdout_gush_armor_bonus"	"护甲削弱："
"[english]DOTA_Tooltip_ability_holdout_gush_armor_bonus"	"ARMOR REDUCTION:"
"DOTA_Tooltip_ability_holdout_gush_duration"	"持续时间："
"[english]DOTA_Tooltip_ability_holdout_gush_duration"	"DURATION:"
"DOTA_Tooltip_ability_holdout_culling_blade"	"刀起人亡"
"[english]DOTA_Tooltip_ability_holdout_culling_blade"	"A Cut Above"
"DOTA_Tooltip_ability_holdout_culling_blade_Description"	"<font color='#70EA72'>斧王向前跳跃进入战场。落地时斧王将对周围所有单位释放淘汰一击。</font>如果有敌人低于秒杀血量就会被斧王瞬间杀死，同时斧王和周围的队友获得临时的加速效果。"
"[english]DOTA_Tooltip_ability_holdout_culling_blade_Description"	"<font color='#70EA72'>Axe leaps forward into combat. Upon landing, Axe delivers a strike to all enemies in a small area around his position.</font>  If an enemy is below the kill threshold, the enemy dies and Axe grants himself and nearby allies a temporary speed bonus."
"DOTA_Tooltip_ability_holdout_culling_blade_Lore"	"蒙哥可汗是战斗与狂怒的化身，胆敢与斧王为敌者只有死路一条。"
"[english]DOTA_Tooltip_ability_holdout_culling_blade_Lore"	"Mogul Khan is the embodiment of battle and fury, launching into a gruesome fatality against those who dare engage the Axe in combat."
"DOTA_Tooltip_ability_holdout_culling_blade_Note0"	"斩杀效果无视魔法免疫。"
"[english]DOTA_Tooltip_ability_holdout_culling_blade_Note0"	"The killing blow goes through magic immunity."
"DOTA_Tooltip_ability_holdout_culling_blade_leap_distance"	"<font color='#70EA72'>跳跃距离：</font>"
"[english]DOTA_Tooltip_ability_holdout_culling_blade_leap_distance"	"<font color='#70EA72'>LEAP DISTANCE:</font>"
"DOTA_Tooltip_ability_holdout_culling_blade_radius"	"<font color='#70EA72'>作用范围：</font>"
"[english]DOTA_Tooltip_ability_holdout_culling_blade_radius"	"<font color='#70EA72'>RADIUS:</font>"
"DOTA_Tooltip_ability_holdout_culling_blade_kill_threshold"	"秒杀血量："
"[english]DOTA_Tooltip_ability_holdout_culling_blade_kill_threshold"	"KILL THRESHOLD:"
"DOTA_Tooltip_ability_holdout_culling_blade_kill_threshold_scepter"	"神杖升级秒杀血量："
"[english]DOTA_Tooltip_ability_holdout_culling_blade_kill_threshold_scepter"	"SCEPTER KILL THRESHOLD:"
"DOTA_Tooltip_ability_holdout_culling_blade_damage"	"伤害："
"[english]DOTA_Tooltip_ability_holdout_culling_blade_damage"	"DAMAGE:"
"DOTA_Tooltip_ability_holdout_culling_blade_speed_bonus"	"%速度提升："
"[english]DOTA_Tooltip_ability_holdout_culling_blade_speed_bonus"	"%SPEED BONUS:"
"DOTA_Tooltip_ability_holdout_culling_blade_speed_aoe"	"加速范围："
"[english]DOTA_Tooltip_ability_holdout_culling_blade_speed_aoe"	"SPEED RADIUS:"
"DOTA_Tooltip_ability_holdout_culling_blade_speed_duration"	"加速持续时间："
"[english]DOTA_Tooltip_ability_holdout_culling_blade_speed_duration"	"SPEED DURATION:"
"DOTA_Tooltip_ability_holdout_culling_blade_speed_duration_scepter"	"神杖升级加速持续时间："
"[english]DOTA_Tooltip_ability_holdout_culling_blade_speed_duration_scepter"	"SCEPTER SPEED DURATION:"
"DOTA_Tooltip_ability_holdout_culling_blade_aghanim_description"	"提高秒杀血量和加速持续时间。"
"[english]DOTA_Tooltip_ability_holdout_culling_blade_aghanim_description"	"Increases kill threshold and speed duration."
"DOTA_Tooltip_ability_holdout_glacier_arrows"	"霜冻之箭"
"[english]DOTA_Tooltip_ability_holdout_glacier_arrows"	"Frost Arrows"
"DOTA_Tooltip_ability_holdout_glacier_arrows_Description"	"卓尔游侠在箭矢中附上冰冻效果，减缓敌人的移动速度。<font color='#70EA72'>每个单位被首次射中后都会被击退。</font>\n\n霜冻之箭是独占攻效，不与其他独占攻效叠加。"
"[english]DOTA_Tooltip_ability_holdout_glacier_arrows_Description"	"Adds a freezing effect to Drow's attacks, slowing enemy movement.  <font color='#70EA72'>Units are knocked back by the initial strike.</font>\n\nFrost Arrows is a Unique Attack Modifier, and does not stack with other Unique Attack Modifiers."
"DOTA_Tooltip_ability_holdout_glacier_arrows_Lore"	"覆盖着寒冰的箭矢破空而出，将敌人冻结致死。"
"[english]DOTA_Tooltip_ability_holdout_glacier_arrows_Lore"	"Ice-encased arrows pierce the silence, chilling their victims to the core."
"DOTA_Tooltip_ability_holdout_glacier_arrows_Note0"	"减速的持续时间在下一支冰箭射中后刷新。"
"[english]DOTA_Tooltip_ability_holdout_glacier_arrows_Note0"	"The slow duration is refreshed on successive casts."
"DOTA_Tooltip_ability_holdout_glacier_arrows_frost_arrows_movement_speed"	"%移动速度提升："
"[english]DOTA_Tooltip_ability_holdout_glacier_arrows_frost_arrows_movement_speed"	"%MOVE SPEED:"
"DOTA_Tooltip_ability_holdout_glacier_arrows_duration"	"<font color='#70EA72'>击退持续时间：</font>"
"[english]DOTA_Tooltip_ability_holdout_glacier_arrows_duration"	"<font color='#70EA72'>KNOCKBACK DURATION:</font>"
"DOTA_Tooltip_ability_holdout_glacier_arrows_slow_duration"	"减速持续时间："
"[english]DOTA_Tooltip_ability_holdout_glacier_arrows_slow_duration"	"SLOW DURATION:"
"DOTA_Tooltip_ability_holdout_glacier_arrows_knockback_distance"	"<font color='#70EA72'>击退距离：</font>"
"[english]DOTA_Tooltip_ability_holdout_glacier_arrows_knockback_distance"	"<font color='#70EA72'>KNOCKBACK DISTANCE:</font>"
"DOTA_Tooltip_ability_holdout_multishot"	"镇压之箭"
"[english]DOTA_Tooltip_ability_holdout_multishot"	"Quelling Shot"
"DOTA_Tooltip_ability_holdout_multishot_Description"	"<font color='#70EA72'>卓尔游侠将她的箭矢分开，同时攻击面前锥形区域内的敌人，但是造成的伤害有所降低。每支箭矢只能攻击一个目标。如果开启霜冻之箭，分开的箭矢也将带有霜冻效果，但是每次射箭的魔耗也相应提高。</font>\n\n镇压之箭是独占攻效，不与其他独占攻效叠加。"
"[english]DOTA_Tooltip_ability_holdout_multishot_Description"	"<font color='#70EA72'>Drow's arrow splits in front of her in a cone shape, dealing less damage but cleaving multiple targets.  Each arrow can only hit a target once.  If Frost Arrows is activated, Quelling Shot's arrows will be converted to Frost Arrows, increasing the mana cost per arrow.</font>\n\nQuelling Shot is a Unique Attack Modifier, and does not stack with other Unique Attack Modifiers."
"DOTA_Tooltip_ability_holdout_multishot_arrow_range"	"距离："
"[english]DOTA_Tooltip_ability_holdout_multishot_arrow_range"	"RANGE:"
"DOTA_Tooltip_ability_holdout_multishot_arrow_count"	"箭矢数量："
"[english]DOTA_Tooltip_ability_holdout_multishot_arrow_count"	"ARROW COUNT:"
"DOTA_Tooltip_ability_holdout_multishot_damage_reduction_pct"	"%基础攻击力降低："
"[english]DOTA_Tooltip_ability_holdout_multishot_damage_reduction_pct"	"%DAMAGE REDUCTION:"
"DOTA_Tooltip_ability_holdout_marksmanship"	"射手天赋"
"[english]DOTA_Tooltip_ability_holdout_marksmanship"	"Marksmanship"
"DOTA_Tooltip_ability_holdout_marksmanship_Description"	"卓尔游侠的战斗经验提高了她的精确度和战斗效率，被动增加敏捷。<font color='#70EA72'>如果一定范围内有敌方生物，敏捷加成消失。</font>"
"[english]DOTA_Tooltip_ability_holdout_marksmanship_Description"	"Drow's experiences in battle improve her accuracy and effectiveness in combat, providing a passive bonus to Agility. <font color='#70EA72'>Grants no bonus if there are enemy creatures within an area of effect.</font>"
"DOTA_Tooltip_ability_holdout_marksmanship_Lore"	"卓尔游侠是弓箭手登峰造极的典型。"
"[english]DOTA_Tooltip_ability_holdout_marksmanship_Lore"	"The Drow Ranger is the epitome of archery prowess."
"DOTA_Tooltip_ability_holdout_marksmanship_marksmanship_agility_bonus"	"敏捷提升："
"[english]DOTA_Tooltip_ability_holdout_marksmanship_marksmanship_agility_bonus"	"BONUS AGILITY:"
"DOTA_Tooltip_ability_holdout_marksmanship_radius"	"<font color='#70EA72'>作用范围：</font>"
"[english]DOTA_Tooltip_ability_holdout_marksmanship_radius"	"<font color='#70EA72'>RADIUS:</font>"
"DOTA_Tooltip_ability_holdout_blade_fury"	"剑刃风暴"
"[english]DOTA_Tooltip_ability_holdout_blade_fury"	"Blade Fury"
"DOTA_Tooltip_ability_holdout_blade_fury_Description"	"舞起具有破坏性力量的剑刃风暴，对主宰周围的敌方单位造成伤害，并使主宰对魔法免疫。持续5秒。<font color='#70EA72'>剑刃风暴造成的伤害也继承剑舞的效果。同时主宰还有几率躲避物理攻击。</font>"
"[english]DOTA_Tooltip_ability_holdout_blade_fury_Description"	"Causes a bladestorm of destructive force around Juggernaut, rendering him immune to magic and dealing damage to nearby enemy units.  <font color='#70EA72'>When Blade Fury deals damage, it has a chance to trigger Blade Dance.  During Blade Fury, Juggernaut has a chance to dodge incoming physical attacks.</font>"
"DOTA_Tooltip_ability_holdout_blade_fury_Lore"	"无论是战士还是法师，都害怕尤涅若的武士刀剑技。"
"[english]DOTA_Tooltip_ability_holdout_blade_fury_Lore"	"Yurnero's renowned katana techniques are feared by warriors and sorcerors alike."
"DOTA_Tooltip_ability_holdout_blade_fury_Note0"	"此技能对机械单位无效。"
"[english]DOTA_Tooltip_ability_holdout_blade_fury_Note0"	"This skill doesn't affect mechanical units."
"DOTA_Tooltip_ability_holdout_blade_fury_Note1"	"在剑刃风暴期间可以使用物品。"
"[english]DOTA_Tooltip_ability_holdout_blade_fury_Note1"	"You can use items during Blade Fury."
"DOTA_Tooltip_ability_holdout_blade_fury_Note2"	"如果单位不会受到剑刃风暴的伤害，主宰可以对其进行物理攻击。"
"[english]DOTA_Tooltip_ability_holdout_blade_fury_Note2"	"If a unit is not being affected by Blade Fury, Juggernaut can perform normal attacks against this unit."
"DOTA_Tooltip_ability_holdout_blade_fury_blade_fury_radius"	"作用范围："
"[english]DOTA_Tooltip_ability_holdout_blade_fury_blade_fury_radius"	"RADIUS:"
"DOTA_Tooltip_ability_holdout_blade_fury_damage"	"伤害："
"[english]DOTA_Tooltip_ability_holdout_blade_fury_damage"	"DAMAGE:"
"DOTA_Tooltip_ability_holdout_blade_fury_duration"	"持续时间："
"[english]DOTA_Tooltip_ability_holdout_blade_fury_duration"	"DURATION:"
"DOTA_Tooltip_ability_holdout_blade_fury_bonus_evasion"	"%<font color='#70EA72'>额外闪避几率：</font>"
"[english]DOTA_Tooltip_ability_holdout_blade_fury_bonus_evasion"	"%<font color='#70EA72'>BONUS EVASION:</font>"
"DOTA_Tooltip_ability_holdout_omnislash"	"秘剑术"
"[english]DOTA_Tooltip_ability_holdout_omnislash"	"Secret Blade"
"DOTA_Tooltip_ability_holdout_omnislash_Description"	"<font color='#70EA72'>主宰向前释放自己的镜像，镜像碰到的单位都会留下记号。在镜像到达目的地后主宰就会向镜像冲去，攻击所有镜像碰到的单位并造成额外伤害。</font>"
"[english]DOTA_Tooltip_ability_holdout_omnislash_Description"	"<font color='#70EA72'>Juggernaut sends forth an image of himself, collecting targets it impacts with.  Upon reaching its destination, Juggernaut dashes forward to the image, attacking all units the image connected with with bonus damage.</font>"
"DOTA_Tooltip_ability_holdout_omnislash_image_radius"	"作用范围："
"[english]DOTA_Tooltip_ability_holdout_omnislash_image_radius"	"RADIUS:"
"DOTA_Tooltip_ability_holdout_omnislash_range"	"距离："
"[english]DOTA_Tooltip_ability_holdout_omnislash_range"	"RANGE:"
"DOTA_Tooltip_ability_holdout_omnislash_bonus_damage"	"额外伤害："
"[english]DOTA_Tooltip_ability_holdout_omnislash_bonus_damage"	"BONUS DAMAGE:"
"DOTA_Tooltip_ability_holdout_storm_bolt"	"风暴之拳"
"[english]DOTA_Tooltip_ability_holdout_storm_bolt"	"Storm Hammer"
"DOTA_Tooltip_ability_holdout_storm_bolt_Description"	"斯温用他充满魔力的手套对敌人造成伤害和眩晕。"
"[english]DOTA_Tooltip_ability_holdout_storm_bolt_Description"	"Sven unleashes his magical gauntlet that deals damage and stuns enemy units."
"DOTA_Tooltip_ability_holdout_storm_bolt_Lore"	"流浪剑客从他父亲的学校里取得的精铁护手能对敌人造成致命打击。"
"[english]DOTA_Tooltip_ability_holdout_storm_bolt_Lore"	"The Rogue Knight's iron gauntlet, taken from the school of his father, strikes his foes to their core."
"DOTA_Tooltip_ability_holdout_storm_bolt_Note0"	"风暴之拳只有目标隐身了才能躲避效果。"
"[english]DOTA_Tooltip_ability_holdout_storm_bolt_Note0"	"Storm Hammer can only be disjointed by going invisible."
"DOTA_Tooltip_ability_holdout_storm_bolt_bolt_stun_duration"	"持续时间："
"[english]DOTA_Tooltip_ability_holdout_storm_bolt_bolt_stun_duration"	"DURATION:"
"DOTA_Tooltip_ability_holdout_storm_bolt_bolt_aoe"	"作用范围："
"[english]DOTA_Tooltip_ability_holdout_storm_bolt_bolt_aoe"	"RADIUS:"
"DOTA_Tooltip_ability_holdout_great_cleave"	"巨力挥舞"
"[english]DOTA_Tooltip_ability_holdout_great_cleave"	"Great Cleave"
"DOTA_Tooltip_ability_holdout_great_cleave_Description"	"斯温以巨力攻击，并对所有附近的敌方单位造成分裂攻击伤害。"
"[english]DOTA_Tooltip_ability_holdout_great_cleave_Description"	"Sven strikes with great force, cleaving all nearby enemy units with his attack."
"DOTA_Tooltip_ability_holdout_great_cleave_Lore"	"守夜骑士团仍然在试图从斯温那里取回被偷走的弃誓之刃，一把能在低阶战士中杀出条大路的利剑。"
"[english]DOTA_Tooltip_ability_holdout_great_cleave_Lore"	"The Vigil Knights still seek to reclaim the stolen Outcast Blade from Sven, a weapon capable of cutting wide swaths through lesser warriors."
"DOTA_Tooltip_ability_holdout_great_cleave_Note0"	"分裂伤害会根据护甲类型有所减少，但是与护甲数值无关。"
"[english]DOTA_Tooltip_ability_holdout_great_cleave_Note0"	"Cleave damage is reduced by armor type but not by armor value."
"DOTA_Tooltip_ability_holdout_great_cleave_Note1"	"分裂伤害无视魔法免疫。"
"[english]DOTA_Tooltip_ability_holdout_great_cleave_Note1"	"Cleave damage goes through magic immunity."
"DOTA_Tooltip_ability_holdout_great_cleave_Note2"	"分裂攻击将对斯温前方的圆形区域。"
"[english]DOTA_Tooltip_ability_holdout_great_cleave_Note2"	"The cleave damages a circular area in front of Sven."
"DOTA_Tooltip_ability_holdout_great_cleave_great_cleave_damage"	"%分裂伤害："
"[english]DOTA_Tooltip_ability_holdout_great_cleave_great_cleave_damage"	"%CLEAVE DAMAGE:"
"DOTA_Tooltip_ability_holdout_great_cleave_great_cleave_radius"	"作用范围："
"[english]DOTA_Tooltip_ability_holdout_great_cleave_great_cleave_radius"	"RADIUS:"
"DOTA_Tooltip_ability_holdout_great_cleave_great_cleave_notes"	"备注：\n\n分裂伤害会根据护甲类型有所减少，但是与护甲数值无关。\n\n分裂伤害无视魔法免疫。\n\n分裂攻击将对斯温前方的圆形区域。"
"[english]DOTA_Tooltip_ability_holdout_great_cleave_great_cleave_notes"	"Notes:\n\nCleave damage is reduced by armor type but not by armor value.\n\nCleave damage goes through magic immunity.\n\nThe cleave damages a circular area in front of Sven."
"DOTA_Tooltip_ability_holdout_warcry"	"战吼"
"[english]DOTA_Tooltip_ability_holdout_warcry"	"Warcry"
"DOTA_Tooltip_ability_holdout_warcry_Description"	"斯温的战吼激励着同伴作战，提升他们的护甲和移动速度。"
"[english]DOTA_Tooltip_ability_holdout_warcry_Description"	"Sven's Warcry heartens his allies for battle, increasing their movement speed and armor."
"DOTA_Tooltip_ability_holdout_warcry_Lore"	"吟诵守夜人法典的句子能够强化斯温对其流浪法则的遵从。太有诗意了！"
"[english]DOTA_Tooltip_ability_holdout_warcry_Lore"	"Calling a few lines from the Vigil Codex fortifies Sven's obedience to his rogue code. So poetic!"
"DOTA_Tooltip_ability_holdout_warcry_Note0"	"与其他提升护甲和速度的技能完全叠加。"
"[english]DOTA_Tooltip_ability_holdout_warcry_Note0"	"Fully stacks with other armor and speed granting abilities."
"DOTA_Tooltip_ability_holdout_warcry_warcry_radius"	"作用范围："
"[english]DOTA_Tooltip_ability_holdout_warcry_warcry_radius"	"RADIUS:"
"DOTA_Tooltip_ability_holdout_warcry_warcry_armor"	"护甲提升："
"[english]DOTA_Tooltip_ability_holdout_warcry_warcry_armor"	"BONUS ARMOR:"
"DOTA_Tooltip_ability_holdout_warcry_warcry_movespeed"	"%<font color='#70EA72'>速度加成：</font>"
"[english]DOTA_Tooltip_ability_holdout_warcry_warcry_movespeed"	"%<font color='#70EA72'>BONUS SPEED:</font>"
"DOTA_Tooltip_ability_holdout_warcry_warcry_duration"	"<font color='#70EA72'>持续时间：</font>"
"[english]DOTA_Tooltip_ability_holdout_warcry_warcry_duration"	"<font color='#70EA72'>DURATION:</font>"
"DOTA_Tooltip_ability_holdout_warcry_warcry_notes"	"备注：\n\n与其他提升护甲的光环完全叠加。\n\n与其他提升移动速度的技能和物品完全叠加。"
"[english]DOTA_Tooltip_ability_holdout_warcry_warcry_notes"	"Notes:\n\nFully stacks with other bonus armor auras from items.\n\nFully stacks with other abilities and items that give a bonus to movement speed."
"DOTA_Tooltip_ability_holdout_gods_strength"	"神之力量"
"[english]DOTA_Tooltip_ability_holdout_gods_strength"	"God's Strength"
"DOTA_Tooltip_ability_holdout_gods_strength_Lore"	"凭借能够击碎神圣之盔的力量，流浪剑客在近身肉搏中未尝一败。"
"[english]DOTA_Tooltip_ability_holdout_gods_strength_Lore"	"With the strength that shattered the Sacred Helm, the Rogue Knight stands unopposed in melee combat."
"DOTA_Tooltip_ability_holdout_gods_strength_bonus_strength"	"力量加成："
"[english]DOTA_Tooltip_ability_holdout_gods_strength_bonus_strength"	"BONUS STRENGTH:"
"DOTA_Tooltip_ability_holdout_gods_strength_cooldown_reduction_per_kill"	"每次击杀后冷却时间减少："
"[english]DOTA_Tooltip_ability_holdout_gods_strength_cooldown_reduction_per_kill"	"COOLDOWN REDUCTION PER KILL:"
"DOTA_Tooltip_ability_holdout_gods_strength_gods_strength_damage"	"%攻击力加成："
"[english]DOTA_Tooltip_ability_holdout_gods_strength_gods_strength_damage"	"%BONUS DAMAGE:"
"DOTA_Tooltip_ability_holdout_scourge_venomous_gale"	"灾厄瘴气"
"[english]DOTA_Tooltip_ability_holdout_scourge_venomous_gale"	"Scourge Gale"
"DOTA_Tooltip_ability_holdout_scourge_venomous_gale_Description"	"沿直线射出一个毒液球，碰到的敌人受到初始伤害和持续伤害，并受到减速效果影响。瘴气在持续时间内每3秒造成一次持续伤害。"
"[english]DOTA_Tooltip_ability_holdout_scourge_venomous_gale_Description"	"Launches a ball of venom in a line, poisoning enemy units so that they take both initial damage and damage over time, as well as suffering slowed movement.  Venomous Gale deals damage every 3 seconds over its duration."
"DOTA_Tooltip_ability_holdout_scourge_venomous_gale_Lore"	"一种由基迪岛丛林里搜集的各种毒针、毒液和毒素混合而成的药剂，几乎没有人能在沾到它后存活下来。"
"[english]DOTA_Tooltip_ability_holdout_scourge_venomous_gale_Lore"	"A concoction of various stings, poisons, and toxins gathered from the jungles of Jidi Isle, victims surviving it are rare."
"DOTA_Tooltip_ability_holdout_scourge_venomous_gale_gale_Note0"	"受到瘴气作用的单位在生命值低于最大值25%的时候可以被反补。"
"[english]DOTA_Tooltip_ability_holdout_scourge_venomous_gale_gale_Note0"	"Units afflicted by Venomous Gale can be denied when their HP drops below 25%."
"DOTA_Tooltip_ability_holdout_scourge_venomous_gale_Note1"	"技能持续时间内每3秒造成一次伤害。"
"[english]DOTA_Tooltip_ability_holdout_scourge_venomous_gale_Note1"	"Duration damage is dealt every 3 seconds."
"DOTA_Tooltip_ability_holdout_scourge_venomous_gale_Note2"	"初始减速效果为50%，减速效果将逐渐降低。"
"[english]DOTA_Tooltip_ability_holdout_scourge_venomous_gale_Note2"	"Slow starts at 50%, and decreases as time passes."
"DOTA_Tooltip_ability_holdout_scourge_venomous_gale_duration"	"持续时间："
"[english]DOTA_Tooltip_ability_holdout_scourge_venomous_gale_duration"	"DURATION:"
"DOTA_Tooltip_ability_holdout_scourge_venomous_gale_strike_damage"	"初始伤害："
"[english]DOTA_Tooltip_ability_holdout_scourge_venomous_gale_strike_damage"	"STRIKE DAMAGE:"
"DOTA_Tooltip_ability_holdout_scourge_venomous_gale_tick_damage"	"持续伤害："
"[english]DOTA_Tooltip_ability_holdout_scourge_venomous_gale_tick_damage"	"DAMAGE OVER TIME:"
"DOTA_Tooltip_ability_holdout_scourge_venomous_gale_movement_slow"	"%移动速度减缓："
"[english]DOTA_Tooltip_ability_holdout_scourge_venomous_gale_movement_slow"	"%SLOW:"
"DOTA_Tooltip_modifier_holdout_scourge_gale"	"灾厄瘴气"
"[english]DOTA_Tooltip_modifier_holdout_scourge_gale"	"Scourge Gale"
"DOTA_Tooltip_modifier_holdout_scourge_gale_Description"	"被减速并不断受到伤害。"
"[english]DOTA_Tooltip_modifier_holdout_scourge_gale_Description"	"Slowed and taking damage over time."
"DOTA_Tooltip_ability_holdout_scourge_ward"	"灾劫守卫"
"[english]DOTA_Tooltip_ability_holdout_scourge_ward"	"Scourge Ward"
"DOTA_Tooltip_ability_holdout_scourge_ward_Description"	"<font color='#70EA72'>召唤一个灾劫守卫攻击敌方单位和建筑。守卫对魔法免疫。灾劫守卫可以施放威力较弱的瘴气，技能等级与剧毒术士的瘴气等级相同。</font>"
"[english]DOTA_Tooltip_ability_holdout_scourge_ward_Description"	"<font color='#70EA72'>Summons a scourge ward to attack enemy units and structures. The ward is immune to magic. Scourge Wards can use a less powerful version of Venomous Gale, and the level is equivalent to the level of Venomancer's Venomous Gale.</font>"
"DOTA_Tooltip_ability_holdout_scourge_ward_Lore"	"他通过将早先的草药学天赋，和后天获得的毒素专精混合起来，创造出一个活体化瘟疫。"
"[english]DOTA_Tooltip_ability_holdout_scourge_ward_Lore"	"A mixture of his old herbalist talents and newfound toxic mastery creates a living embodiment of plague."
"DOTA_Tooltip_ability_holdout_scourge_ward_duration"	"持续时间："
"[english]DOTA_Tooltip_ability_holdout_scourge_ward_duration"	"DURATION:"
"DOTA_Tooltip_ability_holdout_scourge_ward_ward_hp_tooltip"	"守卫生命值："
"[english]DOTA_Tooltip_ability_holdout_scourge_ward_ward_hp_tooltip"	"WARD HP:"
"DOTA_Tooltip_ability_holdout_scourge_ward_ward_damage_tooltip"	"守卫攻击力："
"[english]DOTA_Tooltip_ability_holdout_scourge_ward_ward_damage_tooltip"	"WARD DAMAGE:"
"DOTA_Tooltip_ability_holdout_poison_nova"	"剧毒新星"
"[english]DOTA_Tooltip_ability_holdout_poison_nova"	"Poison Nova"
"DOTA_Tooltip_ability_holdout_poison_nova_Description"	"施放一个剧毒之环，对剧毒术士周围的敌方单位造成持续伤害。剧毒新星的效果不能致死。\n\n可用神杖升级。"
"[english]DOTA_Tooltip_ability_holdout_poison_nova_Description"	"A spreading ring of poison that does damage over time to enemy units around Venomancer.  Poison Nova's effect cannot bring units below 1 HP.\n\nUpgradable by Aghanim's Scepter."
"DOTA_Tooltip_ability_holdout_poison_nova_Lore"	"浓酸丛林中的生物通常会对攻击者释放毒性瘴气来保命；而剧毒术士却将这种瘟疫扩散出基迪岛。"
"[english]DOTA_Tooltip_ability_holdout_poison_nova_Lore"	"In the Acid Jungles, creatures releasing noxious poison to their attackers is common; Venomancer spreads this plague beyond the Jidi Isle."
"DOTA_Tooltip_ability_holdout_poison_nova_Note0"	"剧毒新星造成的伤害不能致死（目标生命值最低为1点）。"
"[english]DOTA_Tooltip_ability_holdout_poison_nova_Note0"	"Poison Nova cannot deal lethal damage (target will be left with 1 HP)."
"DOTA_Tooltip_ability_holdout_poison_nova_radius"	"作用范围："
"[english]DOTA_Tooltip_ability_holdout_poison_nova_radius"	"RADIUS:"
"DOTA_Tooltip_ability_holdout_poison_nova_duration"	"持续时间："
"[english]DOTA_Tooltip_ability_holdout_poison_nova_duration"	"DURATION:"
"DOTA_Tooltip_ability_holdout_poison_nova_damage"	"伤害："
"[english]DOTA_Tooltip_ability_holdout_poison_nova_damage"	"DAMAGE:"
"DOTA_Tooltip_ability_holdout_poison_nova_duration_scepter"	"神杖升级持续时间："
"[english]DOTA_Tooltip_ability_holdout_poison_nova_duration_scepter"	"SCEPTER DURATION:"
"DOTA_Tooltip_ability_holdout_poison_nova_damage_scepter"	"神杖升级伤害："
"[english]DOTA_Tooltip_ability_holdout_poison_nova_damage_scepter"	"SCEPTER DAMAGE:"
"DOTA_Tooltip_ability_holdout_poison_nova_cooldown_scepter"	"神杖升级冷却时间："
"[english]DOTA_Tooltip_ability_holdout_poison_nova_cooldown_scepter"	"SCEPTER COOLDOWN:"
"DOTA_Tooltip_ability_holdout_poison_nova_aghanim_description"	"提高伤害和持续时间，并减少冷却时间。"
"[english]DOTA_Tooltip_ability_holdout_poison_nova_aghanim_description"	"Increases damage and duration, and decreases cooldown."
"DOTA_Tooltip_ability_holdout_shockwave"	"震荡波"
"[english]DOTA_Tooltip_ability_holdout_shockwave"	"Shockwave"
"DOTA_Tooltip_ability_holdout_shockwave_Description"	"马格纳斯放出一道能量波，对一条直线上的敌方单位造成伤害。"
"[english]DOTA_Tooltip_ability_holdout_shockwave_Description"	"Magnus sends out a wave of force, damaging enemy units in a line."
"DOTA_Tooltip_ability_holdout_shockwave_Lore"	"杰尔拉克山体并不稳定，马格纳斯已经学会如何将山体里的回响引导出来。"
"[english]DOTA_Tooltip_ability_holdout_shockwave_Lore"	"Mt. Joerlak was a somewhat unstable mass, and Magnus has learned to channel its reverberations."
"DOTA_Tooltip_ability_holdout_shockwave_shock_damage"	"伤害："
"[english]DOTA_Tooltip_ability_holdout_shockwave_shock_damage"	"DAMAGE:"
"DOTA_Tooltip_ability_holdout_shockwave_shock_distance"	"距离："
"[english]DOTA_Tooltip_ability_holdout_shockwave_shock_distance"	"DISTANCE:"
"DOTA_Tooltip_ability_holdout_friendly_skewer"	"巨角冲撞（队友）"
"[english]DOTA_Tooltip_ability_holdout_friendly_skewer"	"Skewer (Friendly)"
"DOTA_Tooltip_ability_holdout_friendly_skewer_Description"	"<font color='#70EA72'>马格纳斯向前冲刺，将友方英雄用巨大的犀角顶起，带着他们到达目标地点。</font>"
"[english]DOTA_Tooltip_ability_holdout_friendly_skewer_Description"	"<font color='#70EA72'>Magnus rushes forward, picking up friendly Heroes on his massive tusk, carrying them with him to the target destination.</font>"
"DOTA_Tooltip_ability_holdout_friendly_skewer_range"	"距离："
"[english]DOTA_Tooltip_ability_holdout_friendly_skewer_range"	"DISTANCE:"
"DOTA_Tooltip_ability_holdout_friendly_skewer_skewer_speed"	"速度："
"[english]DOTA_Tooltip_ability_holdout_friendly_skewer_skewer_speed"	"SPEED:"
"DOTA_Tooltip_ability_holdout_reverse_polarity"	"两极反转"
"[english]DOTA_Tooltip_ability_holdout_reverse_polarity"	"Reverse Polarity"
"DOTA_Tooltip_ability_holdout_reverse_polarity_Description"	"马格纳斯改变物质的属性，将附近的敌人都拖拽到他的前方，并且以强力的震击对他们造成伤害和眩晕。"
"[english]DOTA_Tooltip_ability_holdout_reverse_polarity_Description"	"Magnus changes properties of matter, sucking all nearby enemies in front of him and stunning them with a powerful slam and dealing damage."
"DOTA_Tooltip_ability_holdout_reverse_polarity_Lore"	"作战时愤怒的马格纳斯如同喷发的杰尔拉克山。"
"[english]DOTA_Tooltip_ability_holdout_reverse_polarity_Lore"	"Magnus fights with the fury of the erupting Mt. Joerlak."
"DOTA_Tooltip_ability_holdout_reverse_polarity_Note0"	"眩晕和牵引效果无视魔法免疫。"
"[english]DOTA_Tooltip_ability_holdout_reverse_polarity_Note0"	"Disable and pull work through magic immunity."
"DOTA_Tooltip_ability_holdout_reverse_polarity_pull_radius"	"拖拽范围："
"[english]DOTA_Tooltip_ability_holdout_reverse_polarity_pull_radius"	"PULL RADIUS:"
"DOTA_Tooltip_ability_holdout_reverse_polarity_polarity_damage"	"<font color='#70EA72'>伤害：</font>"
"[english]DOTA_Tooltip_ability_holdout_reverse_polarity_polarity_damage"	"<font color='#70EA72'>DAMAGE:</font>"
"DOTA_Tooltip_ability_holdout_reverse_polarity_creep_stun_duration"	"小兵眩晕时间："
"[english]DOTA_Tooltip_ability_holdout_reverse_polarity_creep_stun_duration"	"CREEP STUN DURATION:"
"DOTA_Tooltip_ability_holdout_gladiators_unite"	"格斗士，团结起来！"
"[english]DOTA_Tooltip_ability_holdout_gladiators_unite"	"Gladiators, Unite!"
"DOTA_Tooltip_ability_holdout_gladiators_unite_Description"	"<font color='#70EA72'>军团指挥官号召她的盟友聚集，一起在竞技场中战斗。每一个加入竞技场的英雄都会使场内所有英雄的攻击力，护甲和吸血效果得到提升。</font>"
"[english]DOTA_Tooltip_ability_holdout_gladiators_unite_Description"	"<font color='#70EA72'>Legion Commander calls her allied heroes together to fight in an arena.  Each additional friendly hero that joins the fight in the arena grants additional bonus damage, armor, and lifesteal to each arena combatant.</font>"
"DOTA_Tooltip_ability_holdout_gladiators_unite_bonus_armor_per_hero"	"每名英雄的护甲加成："
"[english]DOTA_Tooltip_ability_holdout_gladiators_unite_bonus_armor_per_hero"	"BONUS ARMOR PER HERO:"
"DOTA_Tooltip_ability_holdout_gladiators_unite_bonus_damage_per_hero"	"每个英雄的攻击力加成："
"[english]DOTA_Tooltip_ability_holdout_gladiators_unite_bonus_damage_per_hero"	"BONUS DAMAGE PER HERO:"
"DOTA_Tooltip_ability_holdout_gladiators_unite_lifesteal_per_hero"	"%每个英雄吸血效果："
"[english]DOTA_Tooltip_ability_holdout_gladiators_unite_lifesteal_per_hero"	"%LIFESTEAL PER HERO:"
"DOTA_Tooltip_ability_holdout_gladiators_unite_duration"	"持续时间："
"[english]DOTA_Tooltip_ability_holdout_gladiators_unite_duration"	"DURATION:"
"DOTA_Tooltip_ability_holdout_gladiators_unite_radius"	"作用范围："
"[english]DOTA_Tooltip_ability_holdout_gladiators_unite_radius"	"RADIUS:"
"DOTA_Tooltip_modifier_holdout_gladiators_unite"	"格斗士，团结起来！"
"[english]DOTA_Tooltip_modifier_holdout_gladiators_unite"	"Gladiators, Unite!"
"DOTA_Tooltip_modifier_holdout_gladiators_unite_Description"	"获得%dMODIFIER_PROPERTY_PHYSICAL_ARMOR_BONUS%点额外护甲，%dMODIFIER_PROPERTY_PREATTACK_BONUS_DAMAGE%点额外攻击力和%dMODIFIER_PROPERTY_TOOLTIP%%% 的吸血效果。"
"[english]DOTA_Tooltip_modifier_holdout_gladiators_unite_Description"	"Gaining %dMODIFIER_PROPERTY_PHYSICAL_ARMOR_BONUS% bonus armor, %dMODIFIER_PROPERTY_PREATTACK_BONUS_DAMAGE% bonus damage, and %dMODIFIER_PROPERTY_TOOLTIP%%% lifesteal on physical attacks."
"DOTA_Tooltip_ability_holdout_dragon_slave"	"龙破斩"
"[english]DOTA_Tooltip_ability_holdout_dragon_slave"	"Dragon Slave"
"DOTA_Tooltip_ability_holdout_dragon_slave_Description"	"莉娜引导龙的吐息，放出一波火焰，烧焦所有波及的敌人。"
"[english]DOTA_Tooltip_ability_holdout_dragon_slave_Description"	"Lina channels the breath of a dragon, sending out a wave of fire that scorches every enemy in its path."
"DOTA_Tooltip_ability_holdout_dragon_slave_Lore"	"在纷争之国的荒焦之地，为了娱乐，莉娜学会了操纵沙漠龙的火焰吐息。"
"[english]DOTA_Tooltip_ability_holdout_dragon_slave_Lore"	"In the scorched barren of Misrule, Lina learned to manipulate the fiery breath of the Desert Wyrm as a form of entertainment."
"DOTA_Tooltip_ability_holdout_dragon_slave_Note0"	"龙破斩最远能伤害距离1225码的单位。"
"[english]DOTA_Tooltip_ability_holdout_dragon_slave_Note0"	"Dragon Slave can hit units up to 1225 units away."
"DOTA_Tooltip_ability_holdout_light_strike_array"	"光击阵"
"[english]DOTA_Tooltip_ability_holdout_light_strike_array"	"Light Strike Array"
"DOTA_Tooltip_ability_holdout_light_strike_array_Description"	"召唤柱状火焰伤害并眩晕敌人。"
"[english]DOTA_Tooltip_ability_holdout_light_strike_array_Description"	"Summons a column of flames that damages and stuns enemies."
"DOTA_Tooltip_ability_holdout_light_strike_array_Lore"	"莉娜的精华让她能够集中太阳的能量，随时让空气燃烧。"
"[english]DOTA_Tooltip_ability_holdout_light_strike_array_Lore"	"Lina's essence allows her to focus the sun's energies, causing air to combust at will."
"DOTA_Tooltip_ability_holdout_light_strike_array_Note0"	"光击阵将摧毁作用范围内的树木。"
"[english]DOTA_Tooltip_ability_holdout_light_strike_array_Note0"	"Light Strike Array will destroy trees in its area of effect."
"DOTA_Tooltip_ability_holdout_light_strike_array_light_strike_array_aoe"	"作用范围："
"[english]DOTA_Tooltip_ability_holdout_light_strike_array_light_strike_array_aoe"	"RADIUS:"
"DOTA_Tooltip_ability_holdout_light_strike_array_light_strike_array_stun_duration"	"眩晕时间："
"[english]DOTA_Tooltip_ability_holdout_light_strike_array_light_strike_array_stun_duration"	"STUN DURATION:"
"DOTA_Tooltip_ability_holdout_light_strike_array_light_strike_array_delay_time"	"施法延迟："
"[english]DOTA_Tooltip_ability_holdout_light_strike_array_light_strike_array_delay_time"	"CAST DELAY:"
"DOTA_Tooltip_ability_holdout_fiery_soul"	"炙魂"
"[english]DOTA_Tooltip_ability_holdout_fiery_soul"	"Blazing Soul"
"DOTA_Tooltip_ability_holdout_fiery_soul_Description"	"获得攻击速度和移动速度加成，同时接下来她施放技能时<font color='#70EA72'>施法前摇将会降低</font>。效果能多次叠加。"
"[english]DOTA_Tooltip_ability_holdout_fiery_soul_Description"	"Grants bonus attack speed, movement speed, and <font color='#70EA72'>decreased cast time</font> each time Lina casts a spell. Stacks with itself."
"DOTA_Tooltip_ability_holdout_fiery_soul_Lore"	"舞动的火焰体现了莉娜爱玩的天性，展示了她真实炙热的自我。"
"[english]DOTA_Tooltip_ability_holdout_fiery_soul_Lore"	"Dancing flames embody Lina's playful nature, bringing out her true blazing self."
"DOTA_Tooltip_ability_holdout_fiery_soul_Note0"	"每次施放技能都会刷新持续时间。"
"[english]DOTA_Tooltip_ability_holdout_fiery_soul_Note0"	"Duration refreshes each time a new spell is cast."
"DOTA_Tooltip_ability_holdout_fiery_soul_Note1"	"使用物品不会触发炽魂。"
"[english]DOTA_Tooltip_ability_holdout_fiery_soul_Note1"	"Using items does not trigger Fiery Soul."
"DOTA_Tooltip_ability_holdout_fiery_soul_fiery_soul_attack_speed_bonus"	"攻击速度加成："
"[english]DOTA_Tooltip_ability_holdout_fiery_soul_fiery_soul_attack_speed_bonus"	"ATTACK SPEED BONUS:"
"DOTA_Tooltip_ability_holdout_fiery_soul_fiery_soul_move_speed_bonus"	"%移动速度加成："
"[english]DOTA_Tooltip_ability_holdout_fiery_soul_fiery_soul_move_speed_bonus"	"%MOVE SPEED BONUS:"
"DOTA_Tooltip_ability_holdout_fiery_soul_fiery_soul_max_stacks"	"<font color='#70EA72'>最高叠加次数：</font>"
"[english]DOTA_Tooltip_ability_holdout_fiery_soul_fiery_soul_max_stacks"	"<font color='#70EA72'>MAX STACKS:</font>"
"DOTA_Tooltip_ability_holdout_fiery_soul_duration"	"<font color='#70EA72'>持续时间：</font>"
"[english]DOTA_Tooltip_ability_holdout_fiery_soul_duration"	"<font color='#70EA72'>DURATION:</font>"
"DOTA_Tooltip_ability_holdout_fiery_soul_fiery_soul_cast_point_bonus"	"<font color='#70EA72'>施法前摇加成：</font>"
"[english]DOTA_Tooltip_ability_holdout_fiery_soul_fiery_soul_cast_point_bonus"	"<font color='#70EA72'>CAST POINT BONUS:</font>"
"DOTA_Tooltip_modifier_holdout_fiery_soul"	"炙魂"
"[english]DOTA_Tooltip_modifier_holdout_fiery_soul"	"Blazing Soul"
"DOTA_Tooltip_modifier_holdout_fiery_soul_Description"	"攻击速度提升%dMODIFIER_PROPERTY_ATTACKSPEED_BONUS_CONSTANT%，移动速度提升%dMODIFIER_PROPERTY_MOVESPEED_BONUS_PERCENTAGE%%%，施法前摇减少%fMODIFIER_PROPERTY_TOOLTIP%。"
"[english]DOTA_Tooltip_modifier_holdout_fiery_soul_Description"	"Attack Speed increased by %dMODIFIER_PROPERTY_ATTACKSPEED_BONUS_CONSTANT%, movement Speed by %dMODIFIER_PROPERTY_MOVESPEED_BONUS_PERCENTAGE%%%, and cast point decreased by %fMODIFIER_PROPERTY_TOOLTIP%."
"DOTA_Tooltip_ability_holdout_arcane_aura"	"奥术光环"
"[english]DOTA_Tooltip_ability_holdout_arcane_aura"	"Arcane Aura"
"DOTA_Tooltip_ability_holdout_arcane_aura_Description"	"<font color='#70EA72'>使目标单位获得额外的魔法回复速度。</font> 提升地图上所有友方单位的魔法回复速度。水晶室女享受双倍加成。"
"[english]DOTA_Tooltip_ability_holdout_arcane_aura_Description"	"<font color='#70EA72'>Grants the target unit bonus mana regen.</font>  Passively gives additional mana regeneration to all friendly units on the map. This bonus is doubled on Crystal Maiden."
"DOTA_Tooltip_ability_holdout_arcane_aura_Lore"	"低温提升了魔法精华，莉莱的出现能够让盟友更频繁的使用魔法而不必担心消耗。"
"[english]DOTA_Tooltip_ability_holdout_arcane_aura_Lore"	"Cold temperatures promote the essence of magic, causing Rylai's presence to allow spell usage in abundance."
"DOTA_Tooltip_ability_holdout_arcane_aura_Note0"	"与其他额外魔法回复速率叠加。"
"[english]DOTA_Tooltip_ability_holdout_arcane_aura_Note0"	"Stacks with other flat mana regeneration bonuses."
"DOTA_Tooltip_ability_holdout_arcane_aura_Note1"	"魔法回复速率加成并不是按百分比提升魔法回复速率。"
"[english]DOTA_Tooltip_ability_holdout_arcane_aura_Note1"	"The flat mana regeneration bonus is not considered for percentage mana regeneration increases."
"DOTA_Tooltip_ability_holdout_arcane_aura_mana_regen"	"魔法回复增加："
"[english]DOTA_Tooltip_ability_holdout_arcane_aura_mana_regen"	"MANA REGEN BONUS:"
"DOTA_Tooltip_ability_holdout_arcane_aura_mana_regen_pct"	"%<font color='#70EA72'>魔法回复百分比：</font>"
"[english]DOTA_Tooltip_ability_holdout_arcane_aura_mana_regen_pct"	"%<font color='#70EA72'>MANA REGEN PERCENT:</font>"
"DOTA_Tooltip_ability_holdout_arcane_aura_buff_duration"	"<font color='#70EA72'>效果持续时间：</font>"
"[english]DOTA_Tooltip_ability_holdout_arcane_aura_buff_duration"	"<font color='#70EA72'>BUFF DURATION:</font>"
"DOTA_Tooltip_modifier_holdout_arcane_aura_buff"	"奥术光环回复加成"
"[english]DOTA_Tooltip_modifier_holdout_arcane_aura_buff"	"Arcane Aura Bonus Regen"
"DOTA_Tooltip_modifier_holdout_arcane_aura_buff_Description"	"获得了%dMODIFIER_PROPERTY_MANA_REGEN_PERCENTAGE%%% 额外回魔速度。"
"[english]DOTA_Tooltip_modifier_holdout_arcane_aura_buff_Description"	"Granting %dMODIFIER_PROPERTY_MANA_REGEN_PERCENTAGE%%% bonus mana regen."
"DOTA_Tooltip_modifier_holdout_arcane_aura_self_aura_effect"	"奥术光环"
"[english]DOTA_Tooltip_modifier_holdout_arcane_aura_self_aura_effect"	"Arcane Aura"
"DOTA_Tooltip_modifier_holdout_arcane_aura_self_aura_effect_Description"	"提高 %fMODIFIER_PROPERTY_MANA_REGEN_CONSTANT% 魔法恢复速度"
"[english]DOTA_Tooltip_modifier_holdout_arcane_aura_self_aura_effect_Description"	"Adds %fMODIFIER_PROPERTY_MANA_REGEN_CONSTANT% mana regeneration"
"DOTA_Tooltip_modifier_holdout_arcane_aura_aura_effect"	"奥术光环"
"[english]DOTA_Tooltip_modifier_holdout_arcane_aura_aura_effect"	"Arcane Aura"
"DOTA_Tooltip_modifier_holdout_arcane_aura_aura_effect_Description"	"提高 %fMODIFIER_PROPERTY_MANA_REGEN_CONSTANT% 魔法恢复速度"
"[english]DOTA_Tooltip_modifier_holdout_arcane_aura_aura_effect_Description"	"Adds %fMODIFIER_PROPERTY_MANA_REGEN_CONSTANT% mana regeneration"
"DOTA_Tooltip_ability_holdout_caustic_finale"	"腐尸毒"
"[english]DOTA_Tooltip_ability_holdout_caustic_finale"	"Caustic Finale"
"DOTA_Tooltip_ability_holdout_caustic_finale_Description"	"沙王的攻击会给敌方单位注入毒液，中毒单位死亡时发生剧烈爆炸，造成范围伤害。\n\n腐尸毒是独占攻效，不与其它独占攻效叠加。"
"[english]DOTA_Tooltip_ability_holdout_caustic_finale_Description"	"Sand King's attacks inject a venom that causes enemy units to explode violently upon death, spreading area damage.\n\nCaustic Finale is a Unique Attack Modifier, and does not stack with other Unique Attack Modifier."
"DOTA_Tooltip_ability_holdout_caustic_finale_Lore"	"克里瑟历斯的毒液让受害者变的脆弱并且干涸如干旱的荒地，最后爆炸而死。"
"[english]DOTA_Tooltip_ability_holdout_caustic_finale_Lore"	"An injection from Crixalis makes one brittle and as dry as the arid wastes, subject to implosive demise."
"DOTA_Tooltip_ability_holdout_caustic_finale_Note0"	"该状态下的单位即使没有被沙王亲手杀死也会爆炸。"
"[english]DOTA_Tooltip_ability_holdout_caustic_finale_Note0"	"Units afflicted with the debuff will explode even if Sand King did not deliver the killing blow."
"DOTA_Tooltip_ability_holdout_caustic_finale_Note1"	"状态效果对友方单位无效。"
"[english]DOTA_Tooltip_ability_holdout_caustic_finale_Note1"	"The buff is not placed on allied units."
"DOTA_Tooltip_ability_holdout_caustic_finale_caustic_finale_radius"	"作用范围："
"[english]DOTA_Tooltip_ability_holdout_caustic_finale_caustic_finale_radius"	"RADIUS:"
"DOTA_Tooltip_ability_holdout_Caustic_finale_caustic_finale_duration"	"持续时间："
"[english]DOTA_Tooltip_ability_holdout_Caustic_finale_caustic_finale_duration"	"DURATION:"
"DOTA_Tooltip_ability_holdout_static_remnant"	"残影"
"[english]DOTA_Tooltip_ability_holdout_static_remnant"	"Static Remnant"
"DOTA_Tooltip_ability_holdout_static_remnant_Description"	"风暴之灵制造一个充满爆炸性能量的自身残影，如果有人接近就会引爆造成伤害，<font color='#70EA72'>同时受到当前等级的超负荷作用效果</font>，残影持续12秒。"
"[english]DOTA_Tooltip_ability_holdout_static_remnant_Description"	"Creates an explosively charged image of Storm Spirit that lasts 12 seconds and will detonate and deal damage <font color='#70EA72'>and apply your current level of Overload as a debuff</font> if an enemy unit comes near it."
"DOTA_Tooltip_ability_holdout_static_remnant_Lore"	"雷神·风暴烈酒的二象性让他可以欣赏自己被电时的百态。"
"[english]DOTA_Tooltip_ability_holdout_static_remnant_Lore"	"Raijin Thunderkeg's duality allows him to admire himself in shocking fashion."
"DOTA_Tooltip_ability_holdout_static_remnant_Note0"	"残影在技能施放1秒后才能实体化。"
"[english]DOTA_Tooltip_ability_holdout_static_remnant_Note0"	"Remnants take 1 second to materialize after the spell is cast."
"DOTA_Tooltip_ability_holdout_static_remnant_Note1"	"残影在持续时间内拥有高空视野。"
"[english]DOTA_Tooltip_ability_holdout_static_remnant_Note1"	"Remnants grant flying vision for their duration."
"DOTA_Tooltip_ability_holdout_static_remnant_Note2"	"残影爆炸将伤害260码作用范围内的单位，但是触发范围是235码。"
"[english]DOTA_Tooltip_ability_holdout_static_remnant_Note2"	"The explosion actually hits units in a 260 radius, but will only be triggered in 235."
"DOTA_Tooltip_ability_holdout_static_remnant_static_remnant_damage_radius"	"作用范围："
"[english]DOTA_Tooltip_ability_holdout_static_remnant_static_remnant_damage_radius"	"RADIUS:"
"DOTA_Tooltip_ability_holdout_static_remnant_static_remnant_damage"	"伤害："
"[english]DOTA_Tooltip_ability_holdout_static_remnant_static_remnant_damage"	"DAMAGE:"
"DOTA_Tooltip_ability_holdout_overload"	"超负荷"
"[english]DOTA_Tooltip_ability_holdout_overload"	"Overload"
"DOTA_Tooltip_ability_holdout_overload_Description"	"施法时会产生电荷，在风暴之灵下次攻击时被释放，对附近敌人造成伤害并减速。"
"[english]DOTA_Tooltip_ability_holdout_overload_Description"	"Casting a spell creates an electrical charge, which is released in a burst on his next attack, dealing damage and slowing nearby enemies."
"DOTA_Tooltip_ability_holdout_overload_Lore"	"啪！嘶！咝！"
"[english]DOTA_Tooltip_ability_holdout_overload_Lore"	"Pow!  Zip!  Zap!"
"DOTA_Tooltip_ability_holdout_overload_Note0"	"使用物品不会触发超负荷。"
"[english]DOTA_Tooltip_ability_holdout_overload_Note0"	"Using items doesn't trigger Overload."
"DOTA_Tooltip_ability_holdout_overload_overload_move_slow"	"%移动速度降低："
"[english]DOTA_Tooltip_ability_holdout_overload_overload_move_slow"	"%MOVEMENT SLOW:"
"DOTA_Tooltip_ability_holdout_overload_overload_attack_slow"	"%攻击速度降低："
"[english]DOTA_Tooltip_ability_holdout_overload_overload_attack_slow"	"%ATTACK SLOW:"
"DOTA_Tooltip_ability_holdout_overload_aoe"	"作用范围："
"[english]DOTA_Tooltip_ability_holdout_overload_aoe"	"RADIUS:"
"DOTA_Tooltip_ability_holdout_overload_tooltip_duration"	"<font color='#70EA72'>持续时间：</font>"
"[english]DOTA_Tooltip_ability_holdout_overload_tooltip_duration"	"<font color='#70EA72'>DURATION:</font>"
"DOTA_Tooltip_ability_holdout_electric_vortex"	"电子涡流"
"[english]DOTA_Tooltip_ability_holdout_electric_vortex"	"Electric Vortex"
"DOTA_Tooltip_ability_holdout_electric_vortex_Description"	"将<font color='#70EA72'>附近所有敌人拖到风暴之灵所在位置的涡流</font>，同时也会降低风暴之灵自己50%%的移动速度，持续3秒。"
"[english]DOTA_Tooltip_ability_holdout_electric_vortex_Description"	"A vortex that pulls <font color='#70EA72'>all nearby enemy units to Storm Spirit's location.</font> It also slows the Storm Spirit by 50%% for 3 seconds."
"DOTA_Tooltip_ability_holdout_electric_vortex_Lore"	"雷神狂暴的雷霆力量总是让其他人为之一电。"
"[english]DOTA_Tooltip_ability_holdout_electric_vortex_Lore"	"Raijin's thunderous, boisterous energy often draws others into an electrifying situation."
"DOTA_Tooltip_ability_holdout_electric_vortex_duration"	"DURATION:"
"[english]DOTA_Tooltip_ability_holdout_electric_vortex_duration"	"DURATION:"
"DOTA_Tooltip_ability_holdout_electric_vortex_self_slow"	"自身减速："
"[english]DOTA_Tooltip_ability_holdout_electric_vortex_self_slow"	"SLOW:"
"DOTA_Tooltip_ability_holdout_electric_vortex_radius"	"<font color='#70EA72'>作用范围：</font>"
"[english]DOTA_Tooltip_ability_holdout_electric_vortex_radius"	"<font color='#70EA72'>RADIUS:</font>"
"DOTA_Tooltip_ability_holdout_ball_lightning"	"球状闪电"
"[english]DOTA_Tooltip_ability_holdout_ball_lightning"	"Ball Lightning"
"DOTA_Tooltip_ability_holdout_ball_lightning_Description"	"风暴之灵变成不稳定的电流在战场上横冲直撞，直到他的魔法耗尽或到达目标才停下。每级提升伤害、速度和效果范围，施法消耗为<font color='#70EA72'>15+总魔法量的3%%，每移动100距离消耗10+总魔法量的1%%</font>。本技能造成的伤害每飞行100距离就会递增。"
"[english]DOTA_Tooltip_ability_holdout_ball_lightning_Description"	"Storm Spirit becomes volatile electricity, charging across the battlefield until he depletes his mana or reaches his target.  The mana activation cost is <font color='#70EA72'>15+3%% of his total mana pool, and the cost per 100 units traveled is 5+1%%</font> of his total mana pool Damage is expressed in damage per 100 units traveled."
"DOTA_Tooltip_ability_holdout_ball_lightning_Lore"	"风暴来袭。"
"[english]DOTA_Tooltip_ability_holdout_ball_lightning_Lore"	"The Storm is coming in."
"DOTA_Tooltip_ability_holdout_ball_lightning_Note0"	"行进过程中可以使用瞬发技能。"
"[english]DOTA_Tooltip_ability_holdout_ball_lightning_Note0"	"Instant cast abilities can be used while traveling."
"DOTA_Tooltip_ability_holdout_ball_lightning_Note1"	"该技能可以摧毁树木。"
"[english]DOTA_Tooltip_ability_holdout_ball_lightning_Note1"	"This ability will destroy trees."
"DOTA_Tooltip_ability_holdout_ball_lightning_Note2"	"风暴之灵在球状闪电期间是无敌状态。"
"[english]DOTA_Tooltip_ability_holdout_ball_lightning_Note2"	"Storm Spirit is invulnerable during Ball Lightning."
"DOTA_Tooltip_ability_holdout_ball_lightning_ball_lightning_move_speed"	"速度："
"[english]DOTA_Tooltip_ability_holdout_ball_lightning_ball_lightning_move_speed"	"SPEED:"
"DOTA_Tooltip_ability_holdout_ball_lightning_ball_lightning_aoe"	"作用范围："
"[english]DOTA_Tooltip_ability_holdout_ball_lightning_ball_lightning_aoe"	"RADIUS:"
"DOTA_Tooltip_ability_holdout_ball_lightning_ball_lightning_travel_cost_percent"	"%单位消耗魔法："
"[english]DOTA_Tooltip_ability_holdout_ball_lightning_ball_lightning_travel_cost_percent"	"%MANA DRAIN PER UNIT:"
"DOTA_Tooltip_ability_holdout_queenofpain_shadow_strike"	"暗影突袭"
"[english]DOTA_Tooltip_ability_holdout_queenofpain_shadow_strike"	"Shadow Strike"
"DOTA_Tooltip_ability_holdout_queenofpain_shadow_strike_Description"	"<font color='#70EA72'>猛投一排淬毒匕首造成大量初始伤害，并且在持续时间内不断对碰到的单位造成伤害。中毒单位移动速度降低15秒。</font>后续伤害每3秒结算一次。"
"[english]DOTA_Tooltip_ability_holdout_queenofpain_shadow_strike_Description"	"<font color='#70EA72'>Hurls poisoned daggers in a line which deals large initial damage, and then deals damage over time to any unit it touches. Poisoned units have their movement speed slowed for 15 seconds.</font>  An instance of damage is dealt every 3 seconds."
"DOTA_Tooltip_ability_holdout_queenofpain_shadow_strike_Lore"	"阿卡莎的带毒匕首让她从受害者的痛苦中取得愉悦。"
"[english]DOTA_Tooltip_ability_holdout_queenofpain_shadow_strike_Lore"	"Akasha's envenomed dagger allows her to delight in the drawn out suffering of her victims."
"DOTA_Tooltip_ability_holdout_queenofpain_shadow_strike_Note0"	"受到作用单位在持续时间内将逐秒缓慢地恢复初始移动速度。"
"[english]DOTA_Tooltip_ability_holdout_queenofpain_shadow_strike_Note0"	"The affected unit slowly regains its original movement speed every second during the duration."
"DOTA_Tooltip_ability_holdout_queenofpain_shadow_strike_Note1"	"受到暗影突袭作用的单位在生命值低于最大值25%%时可以被队友反补。"
"[english]DOTA_Tooltip_ability_holdout_queenofpain_shadow_strike_Note1"	"Units afflicted by Shadow Strike can be denied by their allies when their HP drops below 25%% of their maximum health."
"DOTA_Tooltip_ability_holdout_queenofpain_shadow_strike_movement_slow"	"%减速："
"[english]DOTA_Tooltip_ability_holdout_queenofpain_shadow_strike_movement_slow"	"%SLOW:"
"DOTA_Tooltip_ability_holdout_queenofpain_shadow_strike_strike_damage"	"初始伤害："
"[english]DOTA_Tooltip_ability_holdout_queenofpain_shadow_strike_strike_damage"	"STRIKE DAMAGE:"
"DOTA_Tooltip_ability_holdout_queenofpain_shadow_strike_duration_damage"	"持续伤害："
"[english]DOTA_Tooltip_ability_holdout_queenofpain_shadow_strike_duration_damage"	"DAMAGE OVER TIME:"
"DOTA_Tooltip_ability_holdout_queenofpain_shadow_strike_distance"	"距离："
"[english]DOTA_Tooltip_ability_holdout_queenofpain_shadow_strike_distance"	"DISTANCE:"
"DOTA_Tooltip_ability_holdout_queenofpain_shadow_strike_radius"	"作用范围："
"[english]DOTA_Tooltip_ability_holdout_queenofpain_shadow_strike_radius"	"RADIUS:"
"DOTA_Tooltip_ability_holdout_qop_blink"	"闪烁"
"[english]DOTA_Tooltip_ability_holdout_qop_blink"	"Blink"
"DOTA_Tooltip_ability_holdout_qop_blink_Description"	"让痛苦女王自由出入战场的短距离传送。"
"[english]DOTA_Tooltip_ability_holdout_qop_blink_Description"	"Short distance teleportation that allows Queen of Pain to move in and out of combat."
"DOTA_Tooltip_ability_holdout_qop_blink_Lore"	"痛苦女王得名的秘密，你无法从她的痛苦逃脱。"
"[english]DOTA_Tooltip_ability_holdout_qop_blink_Lore"	"The Secret Queen lives up to her title, making her pain impossible to escape."
"DOTA_Tooltip_ability_holdout_qop_blink_Note0"	"如果闪烁距离超过最大距离，那么实际传送的距离将会是最大距离的4/5。"
"[english]DOTA_Tooltip_ability_holdout_qop_blink_Note0"	"If you used Blink to teleport to a distance over the maximum range, you'll be teleported 4/5 of the maximum range instead."
"DOTA_Tooltip_ability_holdout_qop_blink_Note1"	"使用闪烁可以躲避攻击和技能弹道。"
"[english]DOTA_Tooltip_ability_holdout_qop_blink_Note1"	"You can use Blink to dodge incoming projectiles."
"DOTA_Tooltip_ability_holdout_qop_blink_blink_range"	"<font color='#70EA72'>距离：</font>"
"[english]DOTA_Tooltip_ability_holdout_qop_blink_blink_range"	"<font color='#70EA72'>RANGE:</font>"
"DOTA_Tooltip_ability_holdout_scream_of_pain"	"痛苦尖叫"
"[english]DOTA_Tooltip_ability_holdout_scream_of_pain"	"Scream Of Pain"
"DOTA_Tooltip_ability_holdout_scream_of_pain_Description"	"痛苦女王发出刺耳的尖叫，对周围敌人造成伤害。"
"[english]DOTA_Tooltip_ability_holdout_scream_of_pain_Description"	"The Queen of Pain lets loose a piercing scream around her, damaging nearby enemies."
"DOTA_Tooltip_ability_holdout_scream_of_pain_Lore"	"阿卡莎用魅惑的声音吸引她的敌人，偷取他们的灵魂。"
"[english]DOTA_Tooltip_ability_holdout_scream_of_pain_Lore"	"The sultry voice of Akasha beckons her opponents while stealing their souls."
"DOTA_Tooltip_ability_holdout_scream_of_pain_Note0"	"痛苦尖叫能作用隐身单位。"
"[english]DOTA_Tooltip_ability_holdout_scream_of_pain_Note0"	"Scream Of Pain will hit invisible units."
"DOTA_Tooltip_ability_holdout_scream_of_pain_Note1"	"痛苦尖叫无法被躲避。"
"[english]DOTA_Tooltip_ability_holdout_scream_of_pain_Note1"	"Scream Of Pain cannot be disjointed."
"DOTA_Tooltip_ability_holdout_scream_of_pain_area_of_effect"	"作用范围："
"[english]DOTA_Tooltip_ability_holdout_scream_of_pain_area_of_effect"	"RADIUS:"
"DOTA_Tooltip_ability_holdout_sonic_wave"	"超声冲击波"
"[english]DOTA_Tooltip_ability_holdout_sonic_wave"	"Sonic Wave"
"DOTA_Tooltip_ability_holdout_sonic_wave_Description"	"痛苦女王在她面前制造出强大的声波，对其轨迹上的所有敌人造成大量伤害。\n\n可用神杖升级。"
"[english]DOTA_Tooltip_ability_holdout_sonic_wave_Description"	"Creates a gigantic wave of sound in front of Queen of Pain, dealing heavy damage to all enemy units in its wake.\n\nUpgradable with Aghanim's Scepter."
"DOTA_Tooltip_ability_holdout_sonic_wave_Lore"	"她能给你带来的最剧烈的痛苦，阿卡莎的超声冲击波让她可怜的敌人从他们的痛苦中解脱。"
"[english]DOTA_Tooltip_ability_holdout_sonic_wave_Lore"	"Her most exquisite of all of torments, Akasha's Sonic Wave puts her poor foes out of their misery."
"DOTA_Tooltip_ability_holdout_sonic_wave_Note0"	"超声冲击波最远能伤害距离1200码的单位。"
"[english]DOTA_Tooltip_ability_holdout_sonic_wave_Note0"	"Sonic Wave can hit units up to 1200 units away."
"DOTA_Tooltip_ability_holdout_sonic_wave_final_aoe"	"作用范围："
"[english]DOTA_Tooltip_ability_holdout_sonic_wave_final_aoe"	"RADIUS:"
"DOTA_Tooltip_ability_holdout_sonic_wave_damage"	"伤害："
"[english]DOTA_Tooltip_ability_holdout_sonic_wave_damage"	"DAMAGE:"
"DOTA_Tooltip_ability_holdout_sonic_wave_cooldown_scepter"	"<font color='#70EA72'>神杖升级冷却时间：</font>"
"[english]DOTA_Tooltip_ability_holdout_sonic_wave_cooldown_scepter"	"<font color='#70EA72'>SCEPTER COOLDOWN:</font>"
"DOTA_Tooltip_ability_holdout_sonic_wave_damage_scepter"	"神杖升级伤害："
"[english]DOTA_Tooltip_ability_holdout_sonic_wave_damage_scepter"	"SCEPTER DAMAGE:"
"DOTA_Tooltip_ability_holdout_sonic_wave_aghanim_description"	"提高伤害，减少冷却时间。"
"[english]DOTA_Tooltip_ability_holdout_sonic_wave_aghanim_description"	"Increases damage and decreases cooldown."
"DOTA_Tooltip_Ability_Tower_Fortification"	"加强防御"
"[english]DOTA_Tooltip_Ability_Tower_Fortification"	"Fortification"
"DOTA_Tooltip_Ability_Tower_Fortification_Description"	"每轮获得额外护甲值。"
"[english]DOTA_Tooltip_Ability_Tower_Fortification_Description"	"Gaining bonus armor per round."
"DOTA_Tooltip_ability_templar_assassin_refraction_holdout"	"偏光"
"[english]DOTA_Tooltip_ability_templar_assassin_refraction_holdout"	"Deflection"
"DOTA_Tooltip_ability_templar_assassin_refraction_holdout_Lore"	"通过操控她的灵能面纱，拉娜娅让自然法则为她所用。"
"[english]DOTA_Tooltip_ability_templar_assassin_refraction_holdout_Lore"	"Manipulating her psionic veil, Lanaya bends nature's law to her will."
"DOTA_Tooltip_ability_templar_assassin_refraction_holdout_Description"	"圣堂刺客创造一个护盾保护自己，可以吸收伤害并提升自己的攻击力。"
"[english]DOTA_Tooltip_ability_templar_assassin_refraction_holdout_Description"	"Templar Assassin creates a defensive shield around herself that absorbs damage and provides a bonus to her damage."
"DOTA_Tooltip_ability_templar_assassin_refraction_holdout_Note0"	"生命移除类伤害将无视偏光。"
"[english]DOTA_Tooltip_ability_templar_assassin_refraction_holdout_Note0"	"Damage as HP Removal bypasses Deflection."
"DOTA_Tooltip_ability_templar_assassin_refraction_holdout_damage_absorb"	"%伤害吸收量："
"[english]DOTA_Tooltip_ability_templar_assassin_refraction_holdout_damage_absorb"	"%DAMAGE ABSORB:"
"DOTA_Tooltip_ability_templar_assassin_refraction_holdout_bonus_damage"	"%攻击力加成："
"[english]DOTA_Tooltip_ability_templar_assassin_refraction_holdout_bonus_damage"	"%BONUS DAMAGE:"
"DOTA_Tooltip_ability_templar_assassin_refraction_holdout_duration"	"持续时间："
"[english]DOTA_Tooltip_ability_templar_assassin_refraction_holdout_duration"	"DURATION:"
"DOTA_Tooltip_ability_templar_assassin_psionic_trap_holdout"	"灵能陷阱"
"[english]DOTA_Tooltip_ability_templar_assassin_psionic_trap_holdout"	"Psionic Trap"
"DOTA_Tooltip_ability_templar_assassin_psionic_trap_holdout_Lore"	"召唤隐之圣堂降临后，无人能逃脱圣堂刺客的追杀。"
"[english]DOTA_Tooltip_ability_templar_assassin_psionic_trap_holdout_Lore"	"Calling upon the reach of the Hidden Temple, none escape the eye of the Templar."
"DOTA_Tooltip_ability_templar_assassin_psionic_trap_holdout_Description"	"圣堂刺客将一个隐形的神秘陷阱放下以监视敌人的动向，当她启动陷阱时，区域内敌人的移动速度将降低30%%。之后减速效果逐秒增加5%%，最终达到减速50%%。"
"[english]DOTA_Tooltip_ability_templar_assassin_psionic_trap_holdout_Description"	"Templar Assassin places mystical traps that invisibly monitor enemy movement. When sprung, at her command, they exert a slowing influence of 30%% in the area. Traps charge up to slow more by 5%% for each second up to 50%%."
"DOTA_Tooltip_ability_templar_assassin_psionic_trap_holdout_Note0"	"陷阱没有时间限制。"
"[english]DOTA_Tooltip_ability_templar_assassin_psionic_trap_holdout_Note0"	"Traps last indefinitely."
"DOTA_Tooltip_ability_templar_assassin_psionic_trap_holdout_Note1"	"放置后2秒逐渐进入隐身，对魔法免疫，拥有100点生命值。"
"[english]DOTA_Tooltip_ability_templar_assassin_psionic_trap_holdout_Note1"	"They have invisibility that fades in over 2 seconds, magic immunity, and 100 HP."
"DOTA_Tooltip_ability_templar_assassin_psionic_trap_holdout_Note2"	"陷阱的视野是400/400，不能阻止中立生物刷新。"
"[english]DOTA_Tooltip_ability_templar_assassin_psionic_trap_holdout_Note2"	"Traps have 400/400 vision range and don't prevent neutral camps from spawning."
"DOTA_Tooltip_ability_templar_assassin_psionic_trap_holdout_max_traps"	"最大陷阱数："
"[english]DOTA_Tooltip_ability_templar_assassin_psionic_trap_holdout_max_traps"	"MAX TRAPS:"
"DOTA_Tooltip_ability_holdout_paralyzing_cask"	"麻痹药剂"
"[english]DOTA_Tooltip_ability_holdout_paralyzing_cask"	"Paralyzing Cask"
"DOTA_Tooltip_ability_holdout_paralyzing_cask_Description"	"抛出一个装满麻痹粉末的木桶，在敌人中弹跳，眩晕击中的敌人并造成伤害。"
"[english]DOTA_Tooltip_ability_holdout_paralyzing_cask_Description"	"Launches a cask of paralyzing powder that ricochets between enemy units, stunning and damaging those it hits."
"DOTA_Tooltip_ability_holdout_paralyzing_cask_Lore"	"巫医回收倒下的友军和敌人的尸骨，磨成粉末用作他的符咒和炼丹术的材料。"
"[english]DOTA_Tooltip_ability_holdout_paralyzing_cask_Lore"	"The Witch Doctor recycles the bones of fallen friends and foes, using the powder as part of his arsenal of charms and alchemy."
"DOTA_Tooltip_ability_holdout_paralyzing_cask_Note0"	"目标可以受到多次作用，只要附近有其他单位可以进行弹跳。"
"[english]DOTA_Tooltip_ability_holdout_paralyzing_cask_Note0"	"Targets can be hit multiple times, as long as another unit is struck in between the bounces."
"DOTA_Tooltip_ability_holdout_paralyzing_cask_bounces_tooltip"	"弹跳次数："
"[english]DOTA_Tooltip_ability_holdout_paralyzing_cask_bounces_tooltip"	"BOUNCES:"
"DOTA_Tooltip_ability_holdout_paralyzing_cask_hero_duration"	"英雄单位眩晕时间："
"[english]DOTA_Tooltip_ability_holdout_paralyzing_cask_hero_duration"	"HERO STUN DURATION:"
"DOTA_Tooltip_ability_holdout_paralyzing_cask_creep_duration"	"普通单位眩晕时间："
"[english]DOTA_Tooltip_ability_holdout_paralyzing_cask_creep_duration"	"CREEP STUN DURATION:"
"DOTA_Tooltip_ability_holdout_paralyzing_cask_hero_damage"	"英雄受到伤害："
"[english]DOTA_Tooltip_ability_holdout_paralyzing_cask_hero_damage"	"HERO DAMAGE:"
"DOTA_Tooltip_ability_holdout_voodoo_restoration"	"巫毒疗法"
"[english]DOTA_Tooltip_ability_holdout_voodoo_restoration"	"Voodoo Restoration"
"DOTA_Tooltip_ability_holdout_voodoo_restoration_Description"	"巫医集中魔力治疗附近的友军单位。"
"[english]DOTA_Tooltip_ability_holdout_voodoo_restoration_Description"	"Witch Doctor focuses his magic to heal nearby allied units."
"DOTA_Tooltip_ability_holdout_voodoo_restoration_Lore"	"扎瓦克的药酒不仅可以用来戏弄对手，用来治疗小伤也不错。"
"[english]DOTA_Tooltip_ability_holdout_voodoo_restoration_Lore"	"Zharvakko's hocus pocus is not limited only to hexxing his opponents and is quite adept at curing ailments."
"DOTA_Tooltip_ability_holdout_voodoo_restoration_Note0"	"治疗间隔为0.33秒。"
"[english]DOTA_Tooltip_ability_holdout_voodoo_restoration_Note0"	"Healing is done in 0.33 second intervals."
"DOTA_Tooltip_ability_holdout_voodoo_restoration_Note1"	"可以治疗魔法免疫单位。"
"[english]DOTA_Tooltip_ability_holdout_voodoo_restoration_Note1"	"Can heal magic immune units."
"DOTA_Tooltip_ability_holdout_voodoo_restoration_mana_per_second"	"每秒消耗魔法："
"[english]DOTA_Tooltip_ability_holdout_voodoo_restoration_mana_per_second"	"MANA PER SEC:"
"DOTA_Tooltip_ability_holdout_voodoo_restoration_heal"	"治疗量："
"[english]DOTA_Tooltip_ability_holdout_voodoo_restoration_heal"	"HEAL:"
"DOTA_Tooltip_ability_holdout_voodoo_restoration_radius"	"作用范围："
"[english]DOTA_Tooltip_ability_holdout_voodoo_restoration_radius"	"RADIUS:"
"DOTA_Tooltip_ability_holdout_death_ward"	"死亡守卫"
"[english]DOTA_Tooltip_ability_holdout_death_ward"	"Death Ward"
"DOTA_Tooltip_ability_holdout_death_ward_Description"	"持续施法 - 召唤一个死亡守卫攻击敌方英雄。死亡守卫拥有700射程，每0.25秒攻击一次。<font color='#70EA72'>守卫持续10秒</font>。\n\n可用神杖升级。"
"[english]DOTA_Tooltip_ability_holdout_death_ward_Description"	"CHANNELED - Summons a deadly ward to attack enemy heroes.  The Death Ward has attack range of 700, and attacks every .25 seconds. <font color='#70EA72'>Lasts 10 seconds.</font> .\n\nUpgradable by Aghanim's Scepter."
"DOTA_Tooltip_ability_holdout_death_ward_Lore"	"巫医跳起他的传统巫毒舞蹈，在生者的梦中作祟。"
"[english]DOTA_Tooltip_ability_holdout_death_ward_Lore"	"Witch Doctor performs a ritualistic dance, one that haunts the dreams of those who live to recount it."
"DOTA_Tooltip_ability_holdout_death_ward_Note0"	"死亡守卫是无敌的，只有在巫医被打断或持续时间结束后才会被摧毁。"
"[english]DOTA_Tooltip_ability_holdout_death_ward_Note0"	"The Death Ward is invulnerable, and is only destroyed if Witch Doctor is interrupted or its duration expires."
"DOTA_Tooltip_ability_holdout_death_ward_Note1"	"死亡守卫可以受到控制，选择攻击特定目标。"
"[english]DOTA_Tooltip_ability_holdout_death_ward_Note1"	"The Death Ward can be controlled, and made to attack a specific target."
"DOTA_Tooltip_ability_holdout_death_ward_damage"	"攻击力："
"[english]DOTA_Tooltip_ability_holdout_death_ward_damage"	"DAMAGE:"
"DOTA_Tooltip_ability_holdout_death_ward_bounces"	"<font color='#70EA72'>弹射次数：</font>"
"[english]DOTA_Tooltip_ability_holdout_death_ward_bounces"	"<font color='#70EA72'>BOUNCES:</font>"
"DOTA_Tooltip_ability_holdout_death_ward_damage_scepter"	"神杖升级攻击力："
"[english]DOTA_Tooltip_ability_holdout_death_ward_damage_scepter"	"SCEPTER DAMAGE:"
"DOTA_Tooltip_ability_holdout_death_ward_scepter_bounces"	"<font color='#70EA72'>神杖升级弹射次数：</font>"
"[english]DOTA_Tooltip_ability_holdout_death_ward_scepter_bounces"	"<font color='#70EA72'>SCEPTER BOUNCES:</font>"
"DOTA_Tooltip_ability_winter_wyvern_arctic_burn_nb2017"	"严寒烧灼"
"[english]DOTA_Tooltip_ability_winter_wyvern_arctic_burn_nb2017"	"Arctic Burn"
"DOTA_Tooltip_ability_winter_wyvern_arctic_burn_nb2017_Description"	"寒冬飞龙召唤一股极地寒风，<font color='#70EA72'>使目标能</font>无视地形移动，每次攻击都将呼出逼人的寒气。受到作用时，攻击射程更远，攻击弹道速度也更快，被攻击的敌人在寒意作用下，移动速度也被减缓，同时每秒损失%percent_damage%%% 的当前生命值。在夜晚的寒风中，视野还会被加强，在技能期间夜晚将额外获得%night_vision_bonus%的视野范围。\n\n可用神杖升级。"
"[english]DOTA_Tooltip_ability_winter_wyvern_arctic_burn_nb2017_Description"	"Winter Wyvern summons an arctic wind, <font color='#70EA72'>granting the target unit</font> unobstructed movement and allowing her to exhale a blistering chill into each attack. While affected, attacks travel further and faster, and slow enemies with a magical freeze that strips them of %percent_damage%%% of their current health each second. Sight is also hardened against night's chill, granting %night_vision_bonus% additional vision range at night while soaring.\n\nUpgradable by Aghanim's Scepter."
"DOTA_Tooltip_ability_winter_wyvern_arctic_burn_nb2017_Lore"	"在傲洛斯体内，其他龙点燃龙炎的器官熔炼的是难以想象的寒冷。从她咽喉的深处呼出的气会将敌人送入烧灼的痛苦中。"
"[english]DOTA_Tooltip_ability_winter_wyvern_arctic_burn_nb2017_Lore"	"The same organ where some dragons stoke their inner flame is, in Auroth, a crucible of unimaginable cold. From deep within her frosty gullet, an exhalation sends enemies into burning agony."
"DOTA_Tooltip_ability_winter_wyvern_arctic_burn_nb2017_duration"	"飞行持续时间："
"[english]DOTA_Tooltip_ability_winter_wyvern_arctic_burn_nb2017_duration"	"FLIGHT DURATION:"
"DOTA_Tooltip_ability_winter_wyvern_arctic_burn_nb2017_attack_range_bonus"	"攻击距离加成："
"[english]DOTA_Tooltip_ability_winter_wyvern_arctic_burn_nb2017_attack_range_bonus"	"BONUS ATTACK RANGE:"
"DOTA_Tooltip_ability_winter_wyvern_arctic_burn_nb2017_percent_damage"	"%生命烧灼百分比："
"[english]DOTA_Tooltip_ability_winter_wyvern_arctic_burn_nb2017_percent_damage"	"%HEALTH BURN:"
"DOTA_Tooltip_ability_winter_wyvern_arctic_burn_nb2017_move_slow"	"%移动速度减缓："
"[english]DOTA_Tooltip_ability_winter_wyvern_arctic_burn_nb2017_move_slow"	"%MOVEMENT SLOW:"
"DOTA_Tooltip_ability_winter_wyvern_arctic_burn_nb2017_damage_duration"	"烧灼持续时间："
"[english]DOTA_Tooltip_ability_winter_wyvern_arctic_burn_nb2017_damage_duration"	"BURN DURATION:"
"DOTA_Tooltip_ability_winter_wyvern_arctic_burn_nb2017_night_vision_bonus"	"夜晚视野加成："
"[english]DOTA_Tooltip_ability_winter_wyvern_arctic_burn_nb2017_night_vision_bonus"	"ADDED NIGHT VISION RANGE:"
"DOTA_Tooltip_ability_winter_wyvern_arctic_burn_nb2017_mana_cost_scepter"	"神杖升级每秒魔法："
"[english]DOTA_Tooltip_ability_winter_wyvern_arctic_burn_nb2017_mana_cost_scepter"	"SCEPTER MANA PER SECOND:"
"DOTA_Tooltip_ability_winter_wyvern_arctic_burn_nb2017_Note0"	"每次施放严寒灼烧时敌方单位只会获得一次负面效果。"
"[english]DOTA_Tooltip_ability_winter_wyvern_arctic_burn_nb2017_Note0"	"Enemy units can only receive the Arctic Burn debuff once per cast."
"DOTA_Tooltip_ability_winter_wyvern_arctic_burn_nb2017_Note1"	"本技能无法作用于肉山。"
"[english]DOTA_Tooltip_ability_winter_wyvern_arctic_burn_nb2017_Note1"	"This ability does not affect Roshan."
"DOTA_Tooltip_ability_winter_wyvern_arctic_burn_nb2017_Note2"	"攻击前摇降至0.1秒。"
"[english]DOTA_Tooltip_ability_winter_wyvern_arctic_burn_nb2017_Note2"	"Reduces attack point to 0.1."
"DOTA_Tooltip_ability_winter_wyvern_arctic_burn_aghanim_description"	"严寒烧灼变成开关型技能，开启后每秒消耗40点魔法。攻击时每个目标不再只受到一次负面效果。"
"[english]DOTA_Tooltip_ability_winter_wyvern_arctic_burn_aghanim_description"	"Causes Arctic Burn to be a toggle ability, draining 40 mana per second when active. Removes limit on number of attacks per target."
"DOTA_Tooltip_ability_tusk_walrus_wallop_nb2017"	"海象重拳！"
"[english]DOTA_Tooltip_ability_tusk_walrus_wallop_nb2017"	"Walrus WALLOP!"
"DOTA_Tooltip_ability_tusk_walrus_wallop_nb2017_Description"	"巨牙海民挥起有力的重拳，一次强劲的致命一击<font color='#70EA72'>将目标打退。当目标碰到其他敌人时，敌人也会受到暴击伤害，并被击退，但是击退距离变短，技能效果会继续传递到碰到的单位。每个单位每次只会受到一次海象重拳的作用。"
"[english]DOTA_Tooltip_ability_tusk_walrus_wallop_nb2017_Description"	"Tusk connects with his mighty Walrus Wallop, a critical strike so powerful it launches its victim <font color='#70EA72'>forward.  When the unit collides with another enemy, that enemy also takes the crit damage and receives a weaker knockback, continuing the effect on units it hits.  A unit can only be hit once per use of Walrus Wallop"
"DOTA_Tooltip_ability_tusk_walrus_wallop_nb2017_Lore"	"谁打出第一拳往往不重要，看的可是最后一拳。"
"[english]DOTA_Tooltip_ability_tusk_walrus_wallop_nb2017_Lore"	"It never matters who throws the first punch, only who throws the last."
"DOTA_Tooltip_ability_tusk_walrus_wallop_nb2017_Note0"	"本技能的所有效果无视技能免疫。"
"[english]DOTA_Tooltip_ability_tusk_walrus_wallop_nb2017_Note0"	"Works fully on Spell Immune units."
"DOTA_Tooltip_ability_tusk_walrus_wallop_nb2017_crit_multiplier"	"%暴击倍数："
"[english]DOTA_Tooltip_ability_tusk_walrus_wallop_nb2017_crit_multiplier"	"%CRIT MULTIPLIER:"
"DOTA_Tooltip_ability_tusk_walrus_wallop_nb2017_knockback_distance"	"击退距离："
"[english]DOTA_Tooltip_ability_tusk_walrus_wallop_nb2017_knockback_distance"	"KNOCKBACK DISTANCE:"
"DOTA_Tooltip_ability_tusk_walrus_wallop_nb2017_knockback_duration"	"持续时间："
"[english]DOTA_Tooltip_ability_tusk_walrus_wallop_nb2017_knockback_duration"	"DURATION:"
"DOTA_Tooltip_ability_disruptor_glimpse_nb2017"	"恶念瞥视"
"[english]DOTA_Tooltip_ability_disruptor_glimpse_nb2017"	"Glimpse"
"DOTA_Tooltip_ability_disruptor_glimpse_nb2017_Description"	"将<font color='#70EA72'>目标区域内所有敌方单位传送到8秒前的位置。</font>"
"[english]DOTA_Tooltip_ability_disruptor_glimpse_nb2017_Description"	"Teleports <font color='#70EA72'>all enemy units in the target area back to where they were 8 seconds ago.</font>"
"DOTA_Tooltip_ability_disruptor_glimpse_nb2017_Lore"	"对电流的把玩能产生出人意料的结果。"
"[english]DOTA_Tooltip_ability_disruptor_glimpse_nb2017_Lore"	"Playing with electricity can have unexpected results."
"DOTA_Tooltip_ability_disruptor_glimpse_nb2017_Note0"	"飞行时间由目标的飞行距离决定。"
"[english]DOTA_Tooltip_ability_disruptor_glimpse_nb2017_Note0"	"The travel time is a function of the distance the target will travel."
"DOTA_Tooltip_ability_disruptor_glimpse_nb2017_cast_range"	"施法距离："
"[english]DOTA_Tooltip_ability_disruptor_glimpse_nb2017_cast_range"	"CAST RANGE:"
"DOTA_Tooltip_ability_disruptor_glimpse_nb2017_radius"	"作用范围："
"[english]DOTA_Tooltip_ability_disruptor_glimpse_nb2017_radius"	"RADIUS:"
"DOTA_Tooltip_ability_phantom_assassin_stifling_dagger_nb2017"	"窒碍短匕"
"[english]DOTA_Tooltip_ability_phantom_assassin_stifling_dagger_nb2017"	"Stifling Dagger"
"DOTA_Tooltip_ability_phantom_assassin_stifling_dagger_nb2017_Description"	"<font color='#70EA72'>在目标地点周围投掷一阵匕首，每一把都会击中路径上的第一个单位。</font>匕首减缓敌人移动速度，造成%base_damage%+幻影刺客物理攻击的%attack_factor_tooltip%%%的物理伤害，并继承物品和技能的攻击特效。"
"[english]DOTA_Tooltip_ability_phantom_assassin_stifling_dagger_nb2017_Description"	"<font color='#70EA72'>Throws a flurry of daggers at the area around the target point, each one hitting the first unit in its path.</font>  The daggers slow enemy movement speed, and deal %base_damage%+%attack_factor_tooltip%%% of Phantom Assassin's attack damage as physical damage and applying attack effects from items and abilities."
"DOTA_Tooltip_ability_phantom_assassin_stifling_dagger_nb2017_Note0"	"如果攻击效果为几率触发，匕首的触发几率与原几率相同。"
"[english]DOTA_Tooltip_ability_phantom_assassin_stifling_dagger_nb2017_Note0"	"If an attack effect is chance-based, the chance of its application will be the same as its chance to occur."
"DOTA_Tooltip_ability_phantom_assassin_stifling_dagger_nb2017_Lore"	"魅影之纱成员学习到的第一个技能，中招就意味着下一次攻击要来了。"
"[english]DOTA_Tooltip_ability_phantom_assassin_stifling_dagger_nb2017_Lore"	"The first skill learned by the Sisters of the Veil often signals an incoming hit."
"DOTA_Tooltip_ability_phantom_assassin_stifling_dagger_nb2017_move_slow"	"%移动速度减缓："
"[english]DOTA_Tooltip_ability_phantom_assassin_stifling_dagger_nb2017_move_slow"	"%MOVE SLOW:"
"DOTA_Tooltip_ability_phantom_assassin_stifling_dagger_nb2017_duration"	"减速持续时间："
"[english]DOTA_Tooltip_ability_phantom_assassin_stifling_dagger_nb2017_duration"	"SLOW DURATION:"
"DOTA_Tooltip_ability_phantom_assassin_stifling_dagger_nb2017_base_damage"	"基础伤害："
"[english]DOTA_Tooltip_ability_phantom_assassin_stifling_dagger_nb2017_base_damage"	"BASE DAMAGE:"
"DOTA_Tooltip_ability_phantom_assassin_stifling_dagger_nb2017_attack_factor_tooltip"	"%攻击伤害："
"[english]DOTA_Tooltip_ability_phantom_assassin_stifling_dagger_nb2017_attack_factor_tooltip"	"%ATTACK DAMAGE:"
"DOTA_Tooltip_ability_phantom_assassin_stifling_dagger_nb2017_dagger_count"	"匕首数量："
"[english]DOTA_Tooltip_ability_phantom_assassin_stifling_dagger_nb2017_dagger_count"	"DAGGER COUNT:"
"DOTA_Tooltip_ability_phantom_assassin_stifling_dagger_nb2017_dagger_range"	"匕首距离："
"[english]DOTA_Tooltip_ability_phantom_assassin_stifling_dagger_nb2017_dagger_range"	"DAGGER RANGE:"
"DOTA_Tooltip_ability_phantom_assassin_phantom_strike_nb2017"	"幻影突袭"
"[english]DOTA_Tooltip_ability_phantom_assassin_phantom_strike_nb2017"	"Phantom Strike"
"DOTA_Tooltip_ability_phantom_assassin_phantom_strike_nb2017_Description"	"传送至一个友方或敌方单位，并<font color='#70EA72'>获得额外的闪避效果。如果在额外闪避生效期间闪避了普通攻击，幻影刺客有几率通过普通攻击反击近战单位，或者对远程单位施放一把当前等级的窒碍短匕。</font>"
"[english]DOTA_Tooltip_ability_phantom_assassin_phantom_strike_nb2017_Description"	"Teleports to a unit, friendly or enemy, and grants <font color='#70EA72'>bonus evasion.  If an attack is evaded while the bonus evasion is activated, Phantom Assassin has a chance to counter melee attackers with her own attack, and ranged attackers with a dagger of her current level of Stifling Dagger.</font>"
"DOTA_Tooltip_ability_phantom_assassin_phantom_strike_nb2017_Lore"	"莫崔蒂的丝绸面纱是她不幸的目标临终所见之物。"
"[english]DOTA_Tooltip_ability_phantom_assassin_phantom_strike_nb2017_Lore"	"Mortred's silken veil is the last thing her unfortunate target sees."
"DOTA_Tooltip_ability_phantom_assassin_phantom_strike_nb2017_bonus_evasion"	"额外闪避："
"[english]DOTA_Tooltip_ability_phantom_assassin_phantom_strike_nb2017_bonus_evasion"	"BONUS EVASION:"
"DOTA_Tooltip_ability_phantom_assassin_phantom_strike_nb2017_counter_attack_pct"	"%反击几率："
"[english]DOTA_Tooltip_ability_phantom_assassin_phantom_strike_nb2017_counter_attack_pct"	"%COUNTER ATTACK CHANCE:"
"DOTA_Tooltip_ability_phantom_assassin_phantom_strike_nb2017_duration"	"持续时间："
"[english]DOTA_Tooltip_ability_phantom_assassin_phantom_strike_nb2017_duration"	"DURATION:"
"DOTA_Tooltip_modifier_phantom_assassin_phantom_strike_nb2017"	"幻影突袭"
"[english]DOTA_Tooltip_modifier_phantom_assassin_phantom_strike_nb2017"	"Phantom Strike"
"DOTA_Tooltip_modifier_phantom_assassin_phantom_strike_nb2017_Description"	"获得额外闪避，并且成功闪避攻击后反击敌人。"
"[english]DOTA_Tooltip_modifier_phantom_assassin_phantom_strike_nb2017_Description"	"Gaining bonus evasion and counter-attacking dodged attacks."
"DOTA_Tooltip_ability_ember_spirit_flame_guard_nb2017"	"烈火罩"
"[english]DOTA_Tooltip_ability_ember_spirit_flame_guard_nb2017"	"Flame Guard"
"DOTA_Tooltip_ability_ember_spirit_flame_guard_nb2017_Description"	"灰烬之灵用火焰之环将队友包裹起来，接下来的魔法伤害将被全部吸收。烈火罩对周围的敌人造成持续伤害。吸收的伤害超过上限后将失去伤害效果。"
"[english]DOTA_Tooltip_ability_ember_spirit_flame_guard_nb2017_Description"	"Ember Spirit surrounds a friendly target with a ring of fire that consumes incoming magic damage, leaving it unharmed.  Flame Guard deals damage per second in an area while active.  If the shield is broken, the damage is also lost."
"DOTA_Tooltip_ability_ember_spirit_flame_guard_nb2017_duration"	"持续时间："
"[english]DOTA_Tooltip_ability_ember_spirit_flame_guard_nb2017_duration"	"DURATION:"
"DOTA_Tooltip_ability_ember_spirit_flame_guard_nb2017_radius"	"作用范围："
"[english]DOTA_Tooltip_ability_ember_spirit_flame_guard_nb2017_radius"	"RADIUS:"
"DOTA_Tooltip_ability_ember_spirit_flame_guard_nb2017_absorb_amount"	"魔法吸收："
"[english]DOTA_Tooltip_ability_ember_spirit_flame_guard_nb2017_absorb_amount"	"MAGIC ABSORB:"
"DOTA_Tooltip_ability_ember_spirit_flame_guard_nb2017_damage_per_second"	"每秒伤害："
"[english]DOTA_Tooltip_ability_ember_spirit_flame_guard_nb2017_damage_per_second"	"DAMAGE PER SECOND:"
"DOTA_Tooltip_ability_ember_spirit_flame_guard_nb2017_Note0"	"魔法伤害的吸收伤害值计算先于任何伤害减免效果。"
"[english]DOTA_Tooltip_ability_ember_spirit_flame_guard_nb2017_Note0"	"Magic damage reduction is calculated before any reductions."
"DOTA_Tooltip_ability_ember_spirit_flame_guard_nb2017_Lore"	"近身之敌，自讨苦吃。"
"[english]DOTA_Tooltip_ability_ember_spirit_flame_guard_nb2017_Lore"	"An enemy should never be allowed to approach without difficulty."
"DOTA_Tooltip_ability_medusa_mystic_snake_dm2017"	"秘术异蛇"
"[english]DOTA_Tooltip_ability_medusa_mystic_snake_dm2017"	"Mystic Snake"
"DOTA_Tooltip_ability_medusa_mystic_snake_dm2017_Description"	"放出一条秘术异蛇在敌人之间跳跃，造成伤害并偷取魔法值，还会将目标变成石头。抵达最后一个目标后，它会返回到美杜莎身上为其恢复魔法值。每次跳跃造成更多伤害，并偷取%snake_mana_steal%%% 最大魔法值的魔法。对石化凝视作用下的石化单位将造成纯粹伤害。"
"[english]DOTA_Tooltip_ability_medusa_mystic_snake_dm2017_Description"	"A mystic snake made of energy jumps from target to target dealing damage, stealing mana, and turning units to stone. After it reaches its last target, it returns to Medusa to replenish her with mana. The snake deals more damage per jump and steals %snake_mana_steal%%% of the targets' total mana."
"DOTA_Tooltip_ability_medusa_mystic_snake_dm2017_Lore"	"蛇发女妖所受的诅咒也是她最强大的力量。"
"[english]DOTA_Tooltip_ability_medusa_mystic_snake_dm2017_Lore"	"The Gorgon's curse is her greatest strength."
"DOTA_Tooltip_ability_medusa_mystic_snake_dm2017_Note0"	"秘术异蛇无法躲避。"
"[english]DOTA_Tooltip_ability_medusa_mystic_snake_dm2017_Note0"	"Mystic Snake cannot be disjointed."
"DOTA_Tooltip_ability_medusa_mystic_snake_dm2017_radius"	"跳跃范围："
"[english]DOTA_Tooltip_ability_medusa_mystic_snake_dm2017_radius"	"JUMP RADIUS:"
"DOTA_Tooltip_ability_medusa_mystic_snake_dm2017_snake_jumps"	"跳跃次数："
"[english]DOTA_Tooltip_ability_medusa_mystic_snake_dm2017_snake_jumps"	"JUMPS:"
"DOTA_Tooltip_ability_medusa_mystic_snake_dm2017_snake_damage"	"伤害："
"[english]DOTA_Tooltip_ability_medusa_mystic_snake_dm2017_snake_damage"	"DAMAGE:"
"DOTA_Tooltip_ability_medusa_mystic_snake_dm2017_snake_scale"	"%每次跳跃递增伤害："
"[english]DOTA_Tooltip_ability_medusa_mystic_snake_dm2017_snake_scale"	"%DAMAGE INCREASE PER JUMP:"
"DOTA_Tooltip_ability_medusa_mystic_snake_dm2017_snake_mana_steal"	"%魔法窃取："
"[english]DOTA_Tooltip_ability_medusa_mystic_snake_dm2017_snake_mana_steal"	"%MANA STEAL:"
"DOTA_Tooltip_ability_treant_leech_seed_nb2017"	"寄生种子"
"[english]DOTA_Tooltip_ability_treant_leech_seed_nb2017"	"Leech Seed"
"DOTA_Tooltip_ability_treant_leech_seed_nb2017_Description"	"<font color='#70EA72'>冷却结束后，树精卫士的下次攻击</font>会在敌方单位身上种下一颗寄生种子，汲取其生命值同时减缓其移动速度。种子会治疗周围的单位。一共有6波。"
"[english]DOTA_Tooltip_ability_treant_leech_seed_nb2017_Description"	"<font color='#70EA72'>When the cooldown is ready, Leech Seed causes Treant's next attack to</font> plant a life-sapping seed in an enemy unit, draining its health, while simultaneously slowing it. The seed heals friendly units around it.  Pulses 6 times."
"DOTA_Tooltip_ability_treant_leech_seed_nb2017_Lore"	"鲁夫伦特悉心培育的这些生命完全靠闯入他圣地的入侵者的生命力维持。"
"[english]DOTA_Tooltip_ability_treant_leech_seed_nb2017_Lore"	"Rooftrellen nurtures the beings under his stewardship, sustained by the lifeforce of trespassers into his sacred ground."
"DOTA_Tooltip_ability_treant_leech_seed_nb2017_leech_damage"	"每波伤害："
"[english]DOTA_Tooltip_ability_treant_leech_seed_nb2017_leech_damage"	"DAMAGE PER PULSE:"
"DOTA_Tooltip_ability_treant_leech_seed_nb2017_movement_slow"	"%移动速度减缓："
"[english]DOTA_Tooltip_ability_treant_leech_seed_nb2017_movement_slow"	"%MOVEMENT SLOW:"
"DOTA_Tooltip_ability_treant_leech_seed_nb2017_radius"	"作用范围："
"[english]DOTA_Tooltip_ability_treant_leech_seed_nb2017_radius"	"RADIUS:"
"DOTA_Tooltip_ability_treant_leech_seed_nb2017_duration"	"持续时间："
"[english]DOTA_Tooltip_ability_treant_leech_seed_nb2017_duration"	"DURATION:"
"DOTA_Tooltip_ability_treant_great_protector"	"庞然卫士"
"[english]DOTA_Tooltip_ability_treant_great_protector"	"Great Protector"
"DOTA_Tooltip_ability_treant_great_protector_Description"	"树精卫士扎下树根，成长为大树，以损失移动速度为代价获得大量力量加成。"
"[english]DOTA_Tooltip_ability_treant_great_protector_Description"	"Treant plants his roots and grows in size, gaining large amounts of bonus strength while losing movement speed."
"DOTA_Tooltip_ability_treant_great_protector_Lore"	""
"[english]DOTA_Tooltip_ability_treant_great_protector_Lore"	""
"DOTA_Tooltip_ability_treant_great_protector_bonus_strength"	"力量加成："
"[english]DOTA_Tooltip_ability_treant_great_protector_bonus_strength"	"BONUS STRENGTH:"
"DOTA_Tooltip_ability_treant_great_protector_move_speed"	"移动速度："
"[english]DOTA_Tooltip_ability_treant_great_protector_move_speed"	"MOVE SPEED:"
"DOTA_Tooltip_ability_treant_great_protector_duration"	"持续时间："
"[english]DOTA_Tooltip_ability_treant_great_protector_duration"	"DURATION:"
"DOTA_Tooltip_ability_dark_seer_wall_of_replica_nb2017"	"复制之墙"
"[english]DOTA_Tooltip_ability_dark_seer_wall_of_replica_nb2017"	"Wall of Replica"
"DOTA_Tooltip_ability_dark_seer_wall_of_replica_nb2017_Description"	"制造一堵扭曲的光墙，对穿过的任意<font color='#70EA72'>敌方单位</font>造成减速，并复制一个其自身的幻象，幻象由黑暗贤者控制，<font color='#70EA72'>同一时间每个单位只会存在一个幻象。</font>幻象持续到光墙消失，或者被敌人消灭。\n\n可用神杖升级。"
"[english]DOTA_Tooltip_ability_dark_seer_wall_of_replica_nb2017_Description"	"Raises a wall of warping light that slows and creates replicas of any <font color='#70EA72'>enemy unit</font> who crosses it. Enemy replicas serve at the Dark Seer's will. <font color='#70EA72'>Dark Seer may only have one copy an individual enemy unit at a time.</font> Replicas last until they are destroyed, or until the wall's duration ends.\n\nUpgradable by Aghanim's Scepter."
"DOTA_Tooltip_ability_dark_seer_wall_of_replica_Lore"	"尽管黑暗贤者不能回到他原来的国度，他仍然能召唤出一道具有强大心智力量的璀璨幻墙，在敌人之间制造混乱。"
"[english]DOTA_Tooltip_ability_dark_seer_wall_of_replica_Lore"	"The Dark Seer, while unable to return to his natural realm, can channel part of the prismatic wall with powerful strength of mind, sowing confusion amongst enemy ranks."
"DOTA_Tooltip_ability_dark_seer_wall_of_replica_nb2017_Note0"	"幻象和米波的克隆体不会产生幻象。"
"[english]DOTA_Tooltip_ability_dark_seer_wall_of_replica_nb2017_Note0"	"Doesn't create illusions from other illusions, or Meepo clones."
"DOTA_Tooltip_ability_dark_seer_wall_of_replica_nb2017_Note1"	"创造1000码长的光墙，光墙垂直于黑暗贤者和目标点的连线。"
"[english]DOTA_Tooltip_ability_dark_seer_wall_of_replica_nb2017_Note1"	"Creates a wall 1000 units long, perpendicular to the line between Dark Seer and the target point."
"DOTA_Tooltip_ability_dark_seer_wall_of_replica_nb2017_duration"	"墙体持续时间："
"[english]DOTA_Tooltip_ability_dark_seer_wall_of_replica_nb2017_duration"	"WALL DURATION:"
"DOTA_Tooltip_ability_dark_seer_wall_of_replica_nb2017_tooltip_outgoing"	"%复制体攻击力："
"[english]DOTA_Tooltip_ability_dark_seer_wall_of_replica_nb2017_tooltip_outgoing"	"%REPLICA DAMAGE:"
"DOTA_Tooltip_ability_dark_seer_wall_of_replica_nb2017_tooltip_replica_total_damage_incoming"	"%幻象承受伤害："
"[english]DOTA_Tooltip_ability_dark_seer_wall_of_replica_nb2017_tooltip_replica_total_damage_incoming"	"%REPLICA DAMAGE TAKEN:"
"DOTA_Tooltip_ability_dark_seer_wall_of_replica_nb2017_range_tooltip"	"施法距离："
"[english]DOTA_Tooltip_ability_dark_seer_wall_of_replica_nb2017_range_tooltip"	"CAST RANGE:"
"DOTA_Tooltip_ability_dark_seer_wall_of_replica_nb2017_tooltip_outgoing_scepter"	"%神杖升级复制体攻击力："
"[english]DOTA_Tooltip_ability_dark_seer_wall_of_replica_nb2017_tooltip_outgoing_scepter"	"%SCEPTER REPLICA DAMAGE:"
"DOTA_Tooltip_ability_dark_seer_wall_of_replica_nb2017_movement_slow"	"%移动速度减缓："
"[english]DOTA_Tooltip_ability_dark_seer_wall_of_replica_nb2017_movement_slow"	"%MOVEMENT SLOW:"
"DOTA_Tooltip_ability_dark_seer_wall_of_replica_nb2017_slow_duration"	"减速持续时间："
"[english]DOTA_Tooltip_ability_dark_seer_wall_of_replica_nb2017_slow_duration"	"SLOW DURATION:"
"DOTA_Tooltip_ability_zeus_thundergods_wrath_nb2017"	"雷神之援"
"[english]DOTA_Tooltip_ability_zeus_thundergods_wrath_nb2017"	"Thundergod's Salvation"
"DOTA_Tooltip_ability_zeus_thundergods_wrath_nb2017_Description"	"<font color='#70EA72'>宙斯为每名友方英雄召唤一片雷云进行保护，雷云无法移动。每片雷云通过使用宙斯当前等级的雷击攻击附近敌人。</font>"
"[english]DOTA_Tooltip_ability_zeus_thundergods_wrath_nb2017_Description"	"<font color='#70EA72'>Zeus calls down an immobile Cloud for each allied hero for protection.  Each Cloud attacks nearby enemies using Zeus' current level of Lightning Bolt.</font>"
"DOTA_Tooltip_ability_zeus_thundergods_wrath_nb2017_Lore"	"神王毁灭一切胆敢反抗他的敌人，他们无所遁形。"
"[english]DOTA_Tooltip_ability_zeus_thundergods_wrath_nb2017_Lore"	"The Lord of Heaven smites all who oppose him, near or far."
"DOTA_Tooltip_ability_zeus_thundergods_wrath_nb2017_cloud_duration"	"雷云持续时间："
"[english]DOTA_Tooltip_ability_zeus_thundergods_wrath_nb2017_cloud_duration"	"CLOUD DURATION:"
"DOTA_Tooltip_ability_zeus_thundergods_wrath_nb2017_cloud_bolt_interval"	"雷云打击间隔："
"[english]DOTA_Tooltip_ability_zeus_thundergods_wrath_nb2017_cloud_bolt_interval"	"CLOUD STRIKE INTERVAL:"
"DOTA_Tooltip_ability_phoenix_fire_spirits_nb2017"	"烈火精灵"
"[english]DOTA_Tooltip_ability_phoenix_fire_spirits_nb2017"	"Fire Spirits"
"DOTA_Tooltip_ability_phoenix_fire_spirits_nb2017_Description"	"召唤4只围绕凤凰飞行的烈火精灵。每一只烈火精灵都能被单独发射到指定区域。对敌人持续造成伤害并大幅降低他们的攻击速度。<font color='#70EA72'>凤凰根据烈火精灵造成的伤害回复一定百分比的生命。</font>"
"[english]DOTA_Tooltip_ability_phoenix_fire_spirits_nb2017_Description"	"Summons 4 fire spirits that circle around Phoenix. Each spirit can be launched independently at a targeted area of effect. Affected enemy units take damage over time and have their attack speed greatly reduced. <font color='#70EA72'>Phoenix heals a percentage of the damage dealt through Fire Spirits.</font>"
"DOTA_Tooltip_ability_phoenix_fire_spirits_nb2017_Note0"	"烈火精灵现在到达目标区域后将获得1秒的视野。"
"[english]DOTA_Tooltip_ability_phoenix_fire_spirits_nb2017_Note0"	"Fire Spirits reveal the area they strike for 1 second."
"DOTA_Tooltip_ability_phoenix_fire_spirits_nb2017_Lore"	"凤凰那不断坍塌重生的内核经常释放出具有意识的霎那光流。"
"[english]DOTA_Tooltip_ability_phoenix_fire_spirits_nb2017_Lore"	"The ever-collapsing core of Phoenix often emits short-lived bursts of conscious light."
"DOTA_Tooltip_ability_phoenix_fire_spirits_nb2017_hp_cost_perc"	"%生命消耗："
"[english]DOTA_Tooltip_ability_phoenix_fire_spirits_nb2017_hp_cost_perc"	"%HP COST:"
"DOTA_Tooltip_ability_phoenix_fire_spirits_nb2017_spirit_duration"	"精灵持续时间："
"[english]DOTA_Tooltip_ability_phoenix_fire_spirits_nb2017_spirit_duration"	"SPIRIT DURATION:"
"DOTA_Tooltip_ability_phoenix_fire_spirits_nb2017_radius"	"作用范围："
"[english]DOTA_Tooltip_ability_phoenix_fire_spirits_nb2017_radius"	"RADIUS:"
"DOTA_Tooltip_ability_phoenix_fire_spirits_nb2017_duration"	"烧灼持续时间："
"[english]DOTA_Tooltip_ability_phoenix_fire_spirits_nb2017_duration"	"BURN DURATION:"
"DOTA_Tooltip_ability_phoenix_fire_spirits_nb2017_damage_per_second"	"每秒伤害："
"[english]DOTA_Tooltip_ability_phoenix_fire_spirits_nb2017_damage_per_second"	"DAMAGE PER SECOND:"
"DOTA_Tooltip_ability_phoenix_fire_spirits_nb2017_attackspeed_slow"	"攻击速度降低："
"[english]DOTA_Tooltip_ability_phoenix_fire_spirits_nb2017_attackspeed_slow"	"ATTACK SPEED SLOW:"
"DOTA_Tooltip_ability_phoenix_fire_spirits_nb2017_lifesteal_pct"	"%吸血："
"[english]DOTA_Tooltip_ability_phoenix_fire_spirits_nb2017_lifesteal_pct"	"%LIFESTEAL:"
"DOTA_Tooltip_ability_phoenix_launch_fire_spirit_nb2017"	"发射烈火精灵"
"[english]DOTA_Tooltip_ability_phoenix_launch_fire_spirit_nb2017"	"Launch Fire Spirit"
"DOTA_Tooltip_ability_phoenix_launch_fire_spirit_nb2017_Description"	"每一只烈火精灵都能被单独发射到指定区域。对敌人持续造成伤害并大幅降低他们的攻击速度。<font color='#70EA72'>凤凰根据烈火精灵造成的伤害回复一定百分比的生命。</font>"
"[english]DOTA_Tooltip_ability_phoenix_launch_fire_spirit_nb2017_Description"	"Each fire spirit can be launched independently at a targeted area of effect. Affected enemy units take damage over time and have their attack speed greatly reduced. Reveals the area it strikes for 1 second. <font color='#70EA72'>Phoenix heals a percentage of the damage dealt through Fire Spirits.</font>"
"DOTA_Tooltip_ability_phoenix_launch_fire_spirit_nb2017_Lore"	"嘶嘶嘶"
"[english]DOTA_Tooltip_ability_phoenix_launch_fire_spirit_nb2017_Lore"	"PKAWW! BOOM"
"DOTA_Tooltip_ability_phoenix_launch_fire_spirit_nb2017_hp_cost_perc"	"%生命消耗："
"[english]DOTA_Tooltip_ability_phoenix_launch_fire_spirit_nb2017_hp_cost_perc"	"%HP COST:"
"DOTA_Tooltip_ability_phoenix_launch_fire_spirit_nb2017_spirit_duration"	"精灵持续时间："
"[english]DOTA_Tooltip_ability_phoenix_launch_fire_spirit_nb2017_spirit_duration"	"SPIRIT DURATION:"
"DOTA_Tooltip_ability_phoenix_launch_fire_spirit_nb2017_radius"	"作用范围："
"[english]DOTA_Tooltip_ability_phoenix_launch_fire_spirit_nb2017_radius"	"RADIUS:"
"DOTA_Tooltip_ability_phoenix_launch_fire_spirit_nb2017_duration"	"烧灼持续时间："
"[english]DOTA_Tooltip_ability_phoenix_launch_fire_spirit_nb2017_duration"	"BURN DURATION:"
"DOTA_Tooltip_ability_phoenix_launch_fire_spirit_nb2017_damage_per_second"	"每秒伤害："
"[english]DOTA_Tooltip_ability_phoenix_launch_fire_spirit_nb2017_damage_per_second"	"DAMAGE PER SECOND:"
"DOTA_Tooltip_ability_phoenix_launch_fire_spirit_nb2017_attackspeed_slow"	"攻击速度降低："
"[english]DOTA_Tooltip_ability_phoenix_launch_fire_spirit_nb2017_attackspeed_slow"	"ATTACK SPEED SLOW:"
"DOTA_Tooltip_ability_phoenix_launch_fire_spirit_nb2017_lifesteal_pct"	"%吸血："
"[english]DOTA_Tooltip_ability_phoenix_launch_fire_spirit_nb2017_lifesteal_pct"	"%LIFESTEAL:"
"DOTA_Tooltip_ability_keeper_of_the_light_light_elemental"	"召唤光元素"
"[english]DOTA_Tooltip_ability_keeper_of_the_light_light_elemental"	"Summon Light Elemental"
"DOTA_Tooltip_ability_keeper_of_the_light_light_elemental_Description"	"召唤光元素加入战斗。每级都会提升光元素的生命和攻击力。"
"[english]DOTA_Tooltip_ability_keeper_of_the_light_light_elemental_Description"	"Summons a Light Elemental to fight for you.  Each level increases the health and damage of the Elemental."
"DOTA_Tooltip_ability_keeper_of_the_light_light_elemental_summon_duration"	"召唤持续时间："
"[english]DOTA_Tooltip_ability_keeper_of_the_light_light_elemental_summon_duration"	"SUMMON DURATION:"
"DOTA_Tooltip_ability_keeper_of_the_light_light_elemental_summon_hp"	"召唤生命值："
"[english]DOTA_Tooltip_ability_keeper_of_the_light_light_elemental_summon_hp"	"SUMMON HP:"
"DOTA_Tooltip_ability_keeper_of_the_light_light_elemental_summon_damage"	"召唤攻击力："
"[english]DOTA_Tooltip_ability_keeper_of_the_light_light_elemental_summon_damage"	"SUMMON DAMAGE:"
"DOTA_Tooltip_ability_sniper_assassinate_dm2017"	"暗杀"
"[english]DOTA_Tooltip_ability_sniper_assassinate_dm2017"	"Assassinate"
"DOTA_Tooltip_ability_sniper_assassinate_dm2017_Description"	"狙击手锁定一个目标敌方单位，%total_cast_time_tooltip%秒后，从远距离射出一发毁灭性的子弹，远距离造成伤害。<font color='#70EA72'>弹头击中目标后，会眩晕3秒，并且弹片呈锥形散开，对主目标后的单位造成半额伤害。</font> \n\n可用神杖升级。"
"[english]DOTA_Tooltip_ability_sniper_assassinate_dm2017_Description"	"Sniper locks onto a target enemy unit and, after %total_cast_time_tooltip% seconds, fires a devastating shot that deals damage at long range. <font color='#70EA72'>When the shell strikes the target, it stuns it for 3s and causes a scatter shot in a cone, dealing half damage to targets behind the primary target.</font> \n\nUpgradable by Aghanim's Scepter."
"DOTA_Tooltip_ability_sniper_assassinate_aghanim_description"	"暗杀变成点地施放的范围技能，经过持续施法后向范围内单位射出数发子弹，造成致命一击伤害并触发爆头。只能影响视野内英雄。"
"[english]DOTA_Tooltip_ability_sniper_assassinate_aghanim_description"	"Turns Assassinate into a ground target AoE ability, that after the channel period launches a critical strike and procs headshot on units in the AoE. Only affects visible heroes."
"DOTA_Tooltip_ability_sniper_assassinate_dm2017_Lore"	"为了完成预言然后返回家乡，卡德尔必须和参加古老考验那天一样，做出完美的射击。"
"[english]DOTA_Tooltip_ability_sniper_assassinate_dm2017_Lore"	"In order to fulfill the prophecy and return to his home town, Kardel must make another shot as perfect as the one on the day of his ancient test."
"DOTA_Tooltip_ability_sniper_assassinate_dm2017_assassinate_damage"	"伤害："
"[english]DOTA_Tooltip_ability_sniper_assassinate_dm2017_assassinate_damage"	"DAMAGE:"
"DOTA_Tooltip_ability_sniper_assassinate_dm2017_scatter_range"	"散开距离："
"[english]DOTA_Tooltip_ability_sniper_assassinate_dm2017_scatter_range"	"SCATTER RANGE:"
"DOTA_Tooltip_ability_sniper_assassinate_dm2017_Note0"	"准星效果只对队友可见。"
"[english]DOTA_Tooltip_ability_sniper_assassinate_dm2017_Note0"	"Crosshair effect is only visible to allies."
"DOTA_Tooltip_ability_sniper_assassinate_dm2017_Note1"	"隐身不能躲避该技能弹道。"
"[english]DOTA_Tooltip_ability_sniper_assassinate_dm2017_Note1"	"Invisibility doesn't disjoint the projectile."
"DOTA_Tooltip_ability_sniper_assassinate_dm2017_Note2"	"能够打断持续施法技能，打断效果无视技能免疫。"
"[english]DOTA_Tooltip_ability_sniper_assassinate_dm2017_Note2"	"Interrupts channeling spell, including on Spell Immune units."
"DOTA_Tooltip_ability_sniper_assassinate_dm2017_tooltip_range"	"距离："
"[english]DOTA_Tooltip_ability_sniper_assassinate_dm2017_tooltip_range"	"RANGE:"
"DOTA_Tooltip_ability_sniper_assassinate_dm2017_scepter_radius"	"神杖升级作用范围："
"[english]DOTA_Tooltip_ability_sniper_assassinate_dm2017_scepter_radius"	"SCEPTER RADIUS:"
"DOTA_Tooltip_ability_sniper_assassinate_dm2017_scepter_crit_bonus"	"%神杖升级致命一击伤害："
"[english]DOTA_Tooltip_ability_sniper_assassinate_dm2017_scepter_crit_bonus"	"%SCEPTER CRITICAL DAMAGE:"
"DOTA_Tooltip_ability_tiny_trample"	"碾压"
"[english]DOTA_Tooltip_ability_tiny_trample"	"Trample"
"DOTA_Tooltip_ability_tiny_trample_Description"	"小小向前冲去，用崎岖的石块碾压敌方单位。前冲时获得额外移动速度和相位状态，而每个遭到碾压的敌人被眩晕并受到其普通攻击伤害的一定百分比。"
"[english]DOTA_Tooltip_ability_tiny_trample_Description"	"Tiny rushes forward, trampling enemy units with his craggy mass.  He gains bonus movement speed and phased collison, while each enemy he tramples is stunned and dealt a portion of his attack damage."
"DOTA_Tooltip_ability_tiny_trample_attack_factor_tooltip"	"%攻击伤害："
"[english]DOTA_Tooltip_ability_tiny_trample_attack_factor_tooltip"	"%ATTACK DAMAGE:"
"DOTA_Tooltip_ability_tiny_trample_bonus_movespeed_pct"	"%移动速度加成："
"[english]DOTA_Tooltip_ability_tiny_trample_bonus_movespeed_pct"	"%BONUS MOVEMENT SPEED:"
"DOTA_Tooltip_ability_tiny_trample_duration"	"践踏持续时间："
"[english]DOTA_Tooltip_ability_tiny_trample_duration"	"TRAMPLE DURATION:"
"DOTA_Tooltip_ability_tiny_trample_stun_duration"	"眩晕持续时间："
"[english]DOTA_Tooltip_ability_tiny_trample_stun_duration"	"STUN DURATION:"
"DOTA_Tooltip_modifier_tiny_trample"	"碾压"
"[english]DOTA_Tooltip_modifier_tiny_trample"	"Trample"
"DOTA_Tooltip_ability_zuus_static_field_dark_moon"	"静电场"
"[english]DOTA_Tooltip_ability_zuus_static_field_dark_moon"	"Static Field"
"DOTA_Tooltip_ability_zuus_static_field_dark_moon_Description"	"宙斯每次施放技能时都会电击附近所有敌方单位，造成他们当前生命一定比例的伤害。"
"[english]DOTA_Tooltip_ability_zuus_static_field_dark_moon_Description"	"Zeus shocks all nearby enemy units whenever he casts a spell, causing damage proportional to their current health."
"DOTA_Tooltip_ability_zuus_static_field_dark_moon_Lore"	"当天神行于世间，空气中满是静电爆裂。"
"[english]DOTA_Tooltip_ability_zuus_static_field_dark_moon_Lore"	"The air crackles with static when the Thundergod walks the world."
"DOTA_Tooltip_ability_zuus_static_field_dark_moon_Note0"	"静电场造成的伤害要先于当时使用的技能所造成的伤害。"
"[english]DOTA_Tooltip_ability_zuus_static_field_dark_moon_Note0"	"The damage from Static Field is dealt before the damage from the used spell."
"DOTA_Tooltip_ability_zuus_static_field_dark_moon_Note1"	"使用物品不能触发静电场。"
"[english]DOTA_Tooltip_ability_zuus_static_field_dark_moon_Note1"	"Using items doesn't trigger Static Field."
"DOTA_Tooltip_ability_zuus_static_field_dark_moon_Note2"	"静电场的作用效果无需己方视野。"
"[english]DOTA_Tooltip_ability_zuus_static_field_dark_moon_Note2"	"Does not require unit visibility to take effect."
"DOTA_Tooltip_ability_zuus_static_field_dark_moon_damage_health_pct"	"%生命减少："
"[english]DOTA_Tooltip_ability_zuus_static_field_dark_moon_damage_health_pct"	"%HEALTH REDUCTION:"
"DOTA_Tooltip_ability_zuus_static_field_dark_moon_radius"	"作用范围："
"[english]DOTA_Tooltip_ability_zuus_static_field_dark_moon_radius"	"RANGE:"
"DOTA_Tooltip_ability_techies_suicide"	"爆破起飞！"
"[english]DOTA_Tooltip_ability_techies_suicide"	"Blast Off!"
"DOTA_Tooltip_ability_techies_suicide_Description"	"工程师冲到敌人中间，在相遇时引爆炸药，造成大量纯粹范围伤害，并沉默敌人。引爆时会对工程师造成最大生命值<font color='#70EA72'>%hp_cost%%</font>的伤害。"
"[english]DOTA_Tooltip_ability_techies_suicide_Description"	"Techies hurtle themselves into the enemy's midst, detonating charges upon impact which deal massive area of effect pure damage and silence enemies. Upon landing, the assault deals Techies damage equal to <font color='#70EA72'>%hp_cost%%</font> of their max health."
"DOTA_Tooltip_ability_techies_suicide_Lore"	"我们是要去哪？"
"[english]DOTA_Tooltip_ability_techies_suicide_Lore"	"Where we going?"
"DOTA_Tooltip_ability_techies_suicide_damage"	"全额伤害："
"[english]DOTA_Tooltip_ability_techies_suicide_damage"	"FULL DAMAGE:"
"DOTA_Tooltip_ability_techies_suicide_radius"	"作用范围："
"[english]DOTA_Tooltip_ability_techies_suicide_radius"	"RADIUS:"
"DOTA_Tooltip_ability_techies_suicide_silence_duration"	"沉默持续时间："
"[english]DOTA_Tooltip_ability_techies_suicide_silence_duration"	"SILENCE DURATION:"
"DOTA_Tooltip_ability_techies_suicide_hp_cost"	"%对自身的最大生命值伤害："
"[english]DOTA_Tooltip_ability_techies_suicide_hp_cost"	"%MAX HP SELF DAMAGE:"
"DOTA_Tooltip_ability_techies_suicide_Note0"	"若使用本技能后死亡将视为自杀，敌方英雄将不会获得金钱和经验。"
"[english]DOTA_Tooltip_ability_techies_suicide_Note0"	"Dying from this ability counts as suicide, and does not award gold or experience to the enemy team."
"DOTA_Tooltip_ability_techies_suicide_Note1"	"即使自杀，工程师依然能获得杀死的敌方英雄对应的经验值。"
"[english]DOTA_Tooltip_ability_techies_suicide_Note1"	"Techies still earn experience for suicide kills made with this ability."
"DOTA_Tooltip_ability_techies_suicide_Note2"	"自杀攻击将摧毁树木。"
"[english]DOTA_Tooltip_ability_techies_suicide_Note2"	"This ability destroys trees."
}
}
