"hero_chat_wheel"
{
"dota_chatwheel_message_antimage_laugh"	"ฮ้า ฮ่า ฮาฮ่าฮ่าฮาฮะฮะฮ่ะฮ่ะฮ่ะฮ่ะ!"
"[english]dota_chatwheel_message_antimage_laugh"	"Ha ha ha ha ha ha ha ha ha ha ha ha!"
"dota_chatwheel_label_antimage_laugh"	"หัวเราะ"
"[english]dota_chatwheel_label_antimage_laugh"	"Laugh"
"dota_chatwheel_message_antimage_thank"	"ข้าจะซัดพวกมัน ให้ไม่มีวันลืม!"
"[english]dota_chatwheel_message_antimage_thank"	"I'll give them a drubbing they'll not soon forget!"
"dota_chatwheel_label_antimage_thank"	"ข้าจะซัดพวกมัน..."
"[english]dota_chatwheel_label_antimage_thank"	"I'll give them a drubbing..."
"dota_chatwheel_message_antimage_deny"	"นี่เจ้าพยายามแล้วรึ?"
"[english]dota_chatwheel_message_antimage_deny"	"Are you even trying?"
"dota_chatwheel_label_antimage_deny"	"นี่เจ้าพยายามแล้วรึ?"
"[english]dota_chatwheel_label_antimage_deny"	"Are you even trying?"
"dota_chatwheel_message_antimage_1"	"เวทมนตร์ช่างน่ารังเกียจเสียยิ่งนัก"
"[english]dota_chatwheel_message_antimage_1"	"Magic is an abomination."
"dota_chatwheel_label_antimage_1"	"เวทมนตร์ช่างน่ารังเกียจเสียยิ่งนัก"
"[english]dota_chatwheel_label_antimage_1"	"Magic is an abomination."
"dota_chatwheel_message_antimage_2"	"น่าผิดหวังเสียจริง"
"[english]dota_chatwheel_message_antimage_2"	"A disappointment."
"dota_chatwheel_label_antimage_2"	"น่าผิดหวังเสียจริง"
"[english]dota_chatwheel_label_antimage_2"	"A disappointment."
"dota_chatwheel_message_antimage_3"	"ไม่ใช้เวทมนตร์ช่วยตัวเจ้าล่ะ"
"[english]dota_chatwheel_message_antimage_3"	"Magic thyself out of that."
"dota_chatwheel_label_antimage_3"	"ไม่ใช้เวทมนตร์ช่วยตัวเจ้าล่ะ"
"[english]dota_chatwheel_label_antimage_3"	"Magic thyself out of that."
"dota_chatwheel_message_antimage_4"	"เจ้ามันถูกสาป!"
"[english]dota_chatwheel_message_antimage_4"	"Thou art damned!"
"dota_chatwheel_label_antimage_4"	"เจ้ามันถูกสาป"
"[english]dota_chatwheel_label_antimage_4"	"Thou art damned."
"dota_chatwheel_message_antimage_5"	"ส่งเหล่าทหารเทพแห่งความตายของพวกเจ้ามาสิ ข้าจะส่งไปลงนรกให้หมด"
"[english]dota_chatwheel_message_antimage_5"	"Send thy Dead God's legions, I will put them all to death."
"dota_chatwheel_label_antimage_5"	"ส่งเหล่าทหารเทพแห่งความตายมา..."
"[english]dota_chatwheel_label_antimage_5"	"Send thy Dead God's legions..."
"dota_chatwheel_message_axe_laugh"	"ฮ่า ฮ่า ฮ่า ฮ่า ฮ่า ฮ่า!"
"[english]dota_chatwheel_message_axe_laugh"	"Ha ha ha ha ha ha!"
"dota_chatwheel_label_axe_laugh"	"หัวเราะ"
"[english]dota_chatwheel_label_axe_laugh"	"Laugh"
"dota_chatwheel_message_axe_thank"	"Axe ชอบอันนี้มาก ๆ"
"[english]dota_chatwheel_message_axe_thank"	"Axe likes this very much."
"dota_chatwheel_label_axe_thank"	"Axe ชอบอันนี้มาก ๆ"
"[english]dota_chatwheel_label_axe_thank"	"Axe likes this very much."
"dota_chatwheel_message_axe_deny"	"แกไม่สมควรได้รับอะไรทั้งนั้น!"
"[english]dota_chatwheel_message_axe_deny"	"You deserve nothing!"
"dota_chatwheel_label_axe_deny"	"แกไม่สมควรได้รับอะไรทั้งนั้น!"
"[english]dota_chatwheel_label_axe_deny"	"You deserve nothing!"
"dota_chatwheel_message_axe_1"	"แกสู้ว่าแย่แล้ว ตายแย่ยิ่งกว่า"
"[english]dota_chatwheel_message_axe_1"	"You fought badly--died worse."
"dota_chatwheel_label_axe_1"	"แกสู้ว่าแย่แล้ว"
"[english]dota_chatwheel_label_axe_1"	"You fought badly"
"dota_chatwheel_message_axe_2"	"บอกแล้วไงว่าวันนี้ดี!"
"[english]dota_chatwheel_message_axe_2"	"I said good day, sir!"
"dota_chatwheel_label_axe_2"	"บอกแล้วไงว่าวันนี้ดี!"
"[english]dota_chatwheel_label_axe_2"	"I said good day, sir!"
"dota_chatwheel_message_axe_3"	"Axe เข้าใจผิดงั้นเหรอ?"
"[english]dota_chatwheel_message_axe_3"	"Axe misjudged?"
"dota_chatwheel_label_axe_3"	"Axe เข้าใจผิดงั้นเหรอ?"
"[english]dota_chatwheel_label_axe_3"	"Axe misjudged?"
"dota_chatwheel_message_axe_4"	"Axe ไม่มีเวลามาทำไรงั้นงี้หรอกนะ"
"[english]dota_chatwheel_message_axe_4"	"Axe has no time for all this jibber-jabber."
"dota_chatwheel_label_axe_4"	"Axe ไม่มีเวลามาทำไรงั้นงี้หรอกนะ"
"[english]dota_chatwheel_label_axe_4"	"Axe has no time for all this jibber-jabber."
"dota_chatwheel_message_axe_5"	"เกิดอะไรขึ้น? เกิด Axe ขึ้นไง!"
"[english]dota_chatwheel_message_axe_5"	"What happened? Axe happened!"
"dota_chatwheel_label_axe_5"	"เกิดอะไรขึ้น? เกิด Axe ขึ้นไง!"
"[english]dota_chatwheel_label_axe_5"	"What happened? Axe happened!"
"dota_chatwheel_message_bane_laugh"	"ฮ่า ฮ่า ฮ่า ฮ่า ฮ่า ฮ่า ฮ่า ฮ่า ฮ่า!"
"[english]dota_chatwheel_message_bane_laugh"	"Ha ha ha ha ha ha ha ha ha!"
"dota_chatwheel_label_bane_laugh"	"หัวเราะ"
"[english]dota_chatwheel_label_bane_laugh"	"Laugh"
"dota_chatwheel_message_bane_thank"	"เจ้าเป็นคนดีจัง"
"[english]dota_chatwheel_message_bane_thank"	"You're so nice."
"dota_chatwheel_label_bane_thank"	"เจ้าเป็นคนดีจัง"
"[english]dota_chatwheel_label_bane_thank"	"You're so nice."
"dota_chatwheel_message_bane_deny"	"คราวหน้าคงโชคดี"
"[english]dota_chatwheel_message_bane_deny"	"Better luck next time."
"dota_chatwheel_label_bane_deny"	"คราวหน้าคงโชคดี"
"[english]dota_chatwheel_label_bane_deny"	"Better luck next time."
"dota_chatwheel_message_bane_1"	"หายนะในชีวิตเจ้า"
"[english]dota_chatwheel_message_bane_1"	"Bane of your existence."
"dota_chatwheel_label_bane_1"	"หายนะในชีวิตเจ้า"
"[english]dota_chatwheel_label_bane_1"	"Bane of your existence."
"dota_chatwheel_message_bane_2"	"ข้าฝันถึงเหตุการณ์นี้มาตลอด"
"[english]dota_chatwheel_message_bane_2"	"I've been dreaming of this moment."
"dota_chatwheel_label_bane_2"	"ข้าฝันถึงเหตุการณ์นี้มาตลอด"
"[english]dota_chatwheel_label_bane_2"	"I've been dreaming of this moment."
"dota_chatwheel_message_bane_3"	"ก็แลกกันเป็นธรรม"
"[english]dota_chatwheel_message_bane_3"	"Fair exchange."
"dota_chatwheel_label_bane_3"	"ก็แลกกันเป็นธรรม"
"[english]dota_chatwheel_label_bane_3"	"Fair exchange."
"dota_chatwheel_message_bane_4"	"ตอนนี้เจ้าก็ฝันร้ายไปตลอดชีวิต"
"[english]dota_chatwheel_message_bane_4"	"Now your nightmare lasts forever."
"dota_chatwheel_label_bane_4"	"ตอนนี้เจ้าก็ฝันร้ายไปตลอดชีวิต"
"[english]dota_chatwheel_label_bane_4"	"Now your nightmare lasts forever."
"dota_chatwheel_message_bane_5"	"อ้า ย๊า ยา ยา ย่า อ้า อ่าอ๊าอ้า!"
"[english]dota_chatwheel_message_bane_5"	"Ah ya ya ya ya ya yai eeyas!"
"dota_chatwheel_label_bane_5"	"อ้า ย๊า ยา ยา ย่า อ้า อ่าอ๊าอ้า!"
"[english]dota_chatwheel_label_bane_5"	"Ah ya ya ya ya ya yai eeyas!"
"dota_chatwheel_message_bloodseeker_laugh"	"ฮื้มม-ฮื่อ-ฮื่อ-ฮื่อ-ฮื่อ-ฮ่า!"
"[english]dota_chatwheel_message_bloodseeker_laugh"	"Hmm-heh-heh-heh-heh-ha!"
"dota_chatwheel_label_bloodseeker_laugh"	"หัวเราะ"
"[english]dota_chatwheel_label_bloodseeker_laugh"	"Laugh"
"dota_chatwheel_message_bloodseeker_thank"	"เลือดเต็มไปหมด"
"[english]dota_chatwheel_message_bloodseeker_thank"	"So much blood."
"dota_chatwheel_label_bloodseeker_thank"	"เลือดเต็มไปหมด"
"[english]dota_chatwheel_label_bloodseeker_thank"	"So much blood."
"dota_chatwheel_message_bloodseeker_deny"	"ไม่มีเลือดให้แกหรอก"
"[english]dota_chatwheel_message_bloodseeker_deny"	"No blood for you."
"dota_chatwheel_label_bloodseeker_deny"	"ไม่มีเลือดให้แกหรอก"
"[english]dota_chatwheel_label_bloodseeker_deny"	"No blood for you."
"dota_chatwheel_message_bloodseeker_1"	"ข้าเห็นสีแดง...มันน่าลิ้มลองมาก!"
"[english]dota_chatwheel_message_bloodseeker_1"	"I'm seeing red...and it's amazing!"
"dota_chatwheel_label_bloodseeker_1"	"ข้าเห็นสีแดง...มันน่าลิ้มลองมาก!"
"[english]dota_chatwheel_label_bloodseeker_1"	"I'm seeing red...and it's amazing!"
"dota_chatwheel_message_bloodseeker_2"	"อย่าได้อคติ...แกมีสติซะเถอะ"
"[english]dota_chatwheel_message_bloodseeker_2"	"Don't be negative...be positive."
"dota_chatwheel_label_bloodseeker_2"	"อย่าได้อคติ..."
"[english]dota_chatwheel_label_bloodseeker_2"	"Don't be negative..."
"dota_chatwheel_message_bloodseeker_3"	"วิ่งสิ...วิ่ง"
"[english]dota_chatwheel_message_bloodseeker_3"	"Go ahead...run."
"dota_chatwheel_label_bloodseeker_3"	"วิ่งสิ...วิ่ง"
"[english]dota_chatwheel_label_bloodseeker_3"	"Go ahead...run."
"dota_chatwheel_message_bloodseeker_4"	"นอนพักไปก่อน...ยังไม่ต้องรีบ"
"[english]dota_chatwheel_message_bloodseeker_4"	"Lie down...have a cookie."
"dota_chatwheel_label_bloodseeker_4"	"นอนพักไปก่อน...ยังไม่ต้องรีบ"
"[english]dota_chatwheel_label_bloodseeker_4"	"Lie down...have a cookie."
"dota_chatwheel_message_bloodseeker_5"	"ทั่วทั้งสนามรบ กลิ่นเลือดช่างอบอวลสมคำร่ำลือ"
"[english]dota_chatwheel_message_bloodseeker_5"	"Over the field of battle, the smell of blood rises like a promise."
"dota_chatwheel_label_bloodseeker_5"	"ทั่วทั้งสนามรบ..."
"[english]dota_chatwheel_label_bloodseeker_5"	"Over the field of battle..."
"dota_chatwheel_message_crystal_maiden_laugh"	"ฮ้า ฮ่า ฮ่า ฮ่า ฮ่า ฮ่า"
"[english]dota_chatwheel_message_crystal_maiden_laugh"	"Ah ha ha ha ha ha."
"dota_chatwheel_label_crystal_maiden_laugh"	"หัวเราะ"
"[english]dota_chatwheel_label_crystal_maiden_laugh"	"Laugh"
"dota_chatwheel_message_crystal_maiden_thank"	"คุณนี่เย็นได้ใจ!"
"[english]dota_chatwheel_message_crystal_maiden_thank"	"Very cool of you!"
"dota_chatwheel_label_crystal_maiden_thank"	"คุณนี่เย็นได้ใจ!"
"[english]dota_chatwheel_label_crystal_maiden_thank"	"Very cool of you!"
"dota_chatwheel_message_crystal_maiden_deny"	"คราวนี้ก็ไม่มีใครชนะ!"
"[english]dota_chatwheel_message_crystal_maiden_deny"	"Now nobody wins!"
"dota_chatwheel_label_crystal_maiden_deny"	"คราวนี้ก็ไม่มีใครชนะ!"
"[english]dota_chatwheel_label_crystal_maiden_deny"	"Now nobody wins!"
"dota_chatwheel_message_crystal_maiden_1"	"คุณจะได้ไปทำท่านางฟ้าหิมะสวย ๆ"
"[english]dota_chatwheel_message_crystal_maiden_1"	"You'll make a nice snow angel."
"dota_chatwheel_label_crystal_maiden_1"	"คุณจะได้ไปทำท่านางฟ้าหิมะสวย ๆ"
"[english]dota_chatwheel_label_crystal_maiden_1"	"You'll make a nice snow angel."
"dota_chatwheel_message_crystal_maiden_2"	"ขนลุกแล้วค่ะ!"
"[english]dota_chatwheel_message_crystal_maiden_2"	"I've got goosebumps!"
"dota_chatwheel_label_crystal_maiden_2"	"ขนลุกแล้วค่ะ!"
"[english]dota_chatwheel_label_crystal_maiden_2"	"I've got goosebumps!"
"dota_chatwheel_message_crystal_maiden_3"	"ฉันไม่รู้เลยว่าจะเกิดขึ้น"
"[english]dota_chatwheel_message_crystal_maiden_3"	"I didn't see that coming."
"dota_chatwheel_label_crystal_maiden_3"	"ฉันไม่รู้เลยว่าจะเกิดขึ้น"
"[english]dota_chatwheel_label_crystal_maiden_3"	"I didn't see that coming."
"dota_chatwheel_message_crystal_maiden_4"	"มันก็จะดีขึ้นเรื่อย ๆ"
"[english]dota_chatwheel_message_crystal_maiden_4"	"It just keeps getting better."
"dota_chatwheel_label_crystal_maiden_4"	"มันก็จะดีขึ้นเรื่อย ๆ"
"[english]dota_chatwheel_label_crystal_maiden_4"	"It just keeps getting better."
"dota_chatwheel_message_crystal_maiden_5"	"มีใครคิดว่าในนี้หนาวบ้างไหม หรือว่าแค่ฉันคนเดียว?"
"[english]dota_chatwheel_message_crystal_maiden_5"	"Is it cold in here or is it just me?"
"dota_chatwheel_label_crystal_maiden_5"	"มีใครคิดว่าในนี้หนาวบ้างไหม..."
"[english]dota_chatwheel_label_crystal_maiden_5"	"Is it cold in here or..."
"dota_chatwheel_message_drow_ranger_laugh"	"ฮ้า ฮ่า ฮ่า ฮ่า ฮ่า ฮ่า ฮ่า ฮ่า ฮ่า ฮ่า ฮ่า ฮ่า ฮ่า ฮ่า!"
"[english]dota_chatwheel_message_drow_ranger_laugh"	"Ah ha ha ha ha ha ha ha ha ha ha ha ha ha!"
"dota_chatwheel_label_drow_ranger_laugh"	"หัวเราะ"
"[english]dota_chatwheel_label_drow_ranger_laugh"	"Laugh"
"dota_chatwheel_message_drow_ranger_thank"	"ชัยชนะอีกครั้ง!"
"[english]dota_chatwheel_message_drow_ranger_thank"	"Another triumph!"
"dota_chatwheel_label_drow_ranger_thank"	"ชัยชนะอีกครั้ง!"
"[english]dota_chatwheel_label_drow_ranger_thank"	"Another triumph!"
"dota_chatwheel_message_drow_ranger_deny"	"เจ้าน่าจะต้องทำได้ดีกว่านั้น!"
"[english]dota_chatwheel_message_drow_ranger_deny"	"You'll have to do better than that!"
"dota_chatwheel_label_drow_ranger_deny"	"เจ้าน่าจะต้องทำได้ดีกว่านั้น!"
"[english]dota_chatwheel_label_drow_ranger_deny"	"You'll have to do better than that!"
"dota_chatwheel_message_drow_ranger_1"	"เจ้าอยู่ไปก็หนวกหนู"
"[english]dota_chatwheel_message_drow_ranger_1"	"You were too noisy to live."
"dota_chatwheel_label_drow_ranger_1"	"เจ้าอยู่ไปก็หนวกหนู"
"[english]dota_chatwheel_label_drow_ranger_1"	"You were too noisy to live."
"dota_chatwheel_message_drow_ranger_2"	"อ่อนหัด"
"[english]dota_chatwheel_message_drow_ranger_2"	"Amateur."
"dota_chatwheel_label_drow_ranger_2"	"อ่อนหัด"
"[english]dota_chatwheel_label_drow_ranger_2"	"Amateur."
"dota_chatwheel_message_drow_ranger_3"	"มีแค่เจ้าที่ตาย"
"[english]dota_chatwheel_message_drow_ranger_3"	"You die alone."
"dota_chatwheel_label_drow_ranger_3"	"มีแค่เจ้าที่ตาย"
"[english]dota_chatwheel_label_drow_ranger_3"	"You die alone."
"dota_chatwheel_message_drow_ranger_4"	"เรื่องนี้ไม่น่ามีหนทางจบด้วยวิธีอื่นใด"
"[english]dota_chatwheel_message_drow_ranger_4"	"This couldn't have ended any other way."
"dota_chatwheel_label_drow_ranger_4"	"เรื่องนี้ไม่น่ามีหนทางจบ..."
"[english]dota_chatwheel_label_drow_ranger_4"	"This couldn't have ended..."
"dota_chatwheel_message_drow_ranger_5"	"กว่าจะตายได้สักที ข้าจะได้กราบเจ้าง่าย ๆ หน่อย"
"[english]dota_chatwheel_message_drow_ranger_5"	"Now that you're dead, I find it easy to respect you."
"dota_chatwheel_label_drow_ranger_5"	"กว่าจะตายได้สักที..."
"[english]dota_chatwheel_label_drow_ranger_5"	"Now that you're dead..."
"dota_chatwheel_message_earthshaker_laugh"	"ฮ่า ฮ่า ฮ่า ฮ่า ฮ่า ฮ่า ฮ่า ฮ่า ฮ่า"
"[english]dota_chatwheel_message_earthshaker_laugh"	"Ha ha ha ha ha ha ha ha ha."
"dota_chatwheel_label_earthshaker_laugh"	"หัวเราะ"
"[english]dota_chatwheel_label_earthshaker_laugh"	"Laugh"
"dota_chatwheel_message_earthshaker_thank"	"มาสะเทือนโลกกัน!"
"[english]dota_chatwheel_message_earthshaker_thank"	"Let's shake things up!"
"dota_chatwheel_label_earthshaker_thank"	"มาสะเทือนโลกกัน!"
"[english]dota_chatwheel_label_earthshaker_thank"	"Let's shake things up!"
"dota_chatwheel_message_earthshaker_deny"	"น่าตะลึง..."
"[english]dota_chatwheel_message_earthshaker_deny"	"Shocking..."
"dota_chatwheel_label_earthshaker_deny"	"น่าตะลึง..."
"[english]dota_chatwheel_label_earthshaker_deny"	"Shocking..."
"dota_chatwheel_message_earthshaker_1"	"มันเป็นความผิดที่เจ้าก่อเอง"
"[english]dota_chatwheel_message_earthshaker_1"	"It was your own damn fault."
"dota_chatwheel_label_earthshaker_1"	"มันเป็นความผิดที่เจ้าก่อเอง"
"[english]dota_chatwheel_label_earthshaker_1"	"It was your own damn fault."
"dota_chatwheel_message_earthshaker_2"	"โอ้ว... ตามมาอีกระลอก..."
"[english]dota_chatwheel_message_earthshaker_2"	"Whoa... Aftershocks..."
"dota_chatwheel_label_earthshaker_2"	"โอ้ว... ตามมาอีกระลอก..."
"[english]dota_chatwheel_label_earthshaker_2"	"Whoa... Aftershocks..."
"dota_chatwheel_message_earthshaker_3"	"ทุบ...ไม่โดน?"
"[english]dota_chatwheel_message_earthshaker_3"	"Slammin'...?"
"dota_chatwheel_label_earthshaker_3"	"ทุบ...ไม่โดน?"
"[english]dota_chatwheel_label_earthshaker_3"	"Slammin'...?"
"dota_chatwheel_message_earthshaker_4"	"มันชักจะอึดอัดเกินไปหน่อย"
"[english]dota_chatwheel_message_earthshaker_4"	"It was getting far too crowded."
"dota_chatwheel_label_earthshaker_4"	"มันชักจะอึดอัดเกินไปหน่อย"
"[english]dota_chatwheel_label_earthshaker_4"	"It was getting far too crowded."
"dota_chatwheel_message_earthshaker_5"	"โลกอาจมีได้หลายดวง แต่ Earthshaker มีได้เพียงหนึ่งเดียว"
"[english]dota_chatwheel_message_earthshaker_5"	"There may be many earths, but there's only one Earthshaker."
"dota_chatwheel_label_earthshaker_5"	"โลกอาจมีได้หลายดวง..."
"[english]dota_chatwheel_label_earthshaker_5"	"There may be many earths..."
"dota_chatwheel_message_juggernaut_laugh"	"ฮ่า ฮ่า ฮ่า ฮ่า ฮ่า!"
"[english]dota_chatwheel_message_juggernaut_laugh"	"Ha ha ha ha ha!"
"dota_chatwheel_label_juggernaut_laugh"	"หัวเราะ"
"[english]dota_chatwheel_label_juggernaut_laugh"	"Laugh"
"dota_chatwheel_message_juggernaut_thank"	"โอ้ เยี่ยมไปเลย"
"[english]dota_chatwheel_message_juggernaut_thank"	"Oh that's nice."
"dota_chatwheel_label_juggernaut_thank"	"โอ้ เยี่ยมไปเลย"
"[english]dota_chatwheel_label_juggernaut_thank"	"Oh that's nice."
"dota_chatwheel_message_juggernaut_deny"	"อืม ก็ดูดีนิ"
"[english]dota_chatwheel_message_juggernaut_deny"	"Hm, looking good."
"dota_chatwheel_label_juggernaut_deny"	"อืม ก็ดูดีนิ"
"[english]dota_chatwheel_label_juggernaut_deny"	"Hm, looking good."
"dota_chatwheel_message_juggernaut_1"	"เจ้าจะต้องอยู่คนเดียวตลอดไป"
"[english]dota_chatwheel_message_juggernaut_1"	"You will be forever alone."
"dota_chatwheel_label_juggernaut_1"	"เจ้าจะต้องอยู่คนเดียวตลอดไป"
"[english]dota_chatwheel_label_juggernaut_1"	"You will be forever alone."
"dota_chatwheel_message_juggernaut_2"	"ทุกอย่างกำลังลงตัว"
"[english]dota_chatwheel_message_juggernaut_2"	"It's all falling into place."
"dota_chatwheel_label_juggernaut_2"	"ทุกอย่างกำลังลงตัว"
"[english]dota_chatwheel_label_juggernaut_2"	"It's all falling into place."
"dota_chatwheel_message_juggernaut_3"	"ข้าจะกลับมาเคลียร์เรื่องนี้ทีหลัง"
"[english]dota_chatwheel_message_juggernaut_3"	"I'll be back to finish this later."
"dota_chatwheel_label_juggernaut_3"	"ข้าจะกลับมาเคลียร์เรื่องนี้ทีหลัง"
"[english]dota_chatwheel_label_juggernaut_3"	"I'll be back to finish this later."
"dota_chatwheel_message_juggernaut_4"	"มันมีเส้นบาง ๆ กั้นอยู่ระหว่าง กล้า กับ โง่"
"[english]dota_chatwheel_message_juggernaut_4"	"There's a fine line between bravery and stupidity."
"dota_chatwheel_label_juggernaut_4"	"มันมีเส้นบาง ๆ กั้นอยู่..."
"[english]dota_chatwheel_label_juggernaut_4"	"There's a fine line..."
"dota_chatwheel_message_juggernaut_5"	"อื้ม เด่นไม่เบา"
"[english]dota_chatwheel_message_juggernaut_5"	"Mm, snazzy."
"dota_chatwheel_label_juggernaut_5"	"อื้ม เด่นไม่เบา"
"[english]dota_chatwheel_label_juggernaut_5"	"Mm, snazzy."
"dota_chatwheel_message_mirana_laugh"	"ฮ่า ฮ่า ฮ่า ฮ่า ฮ่า ฮ่า!"
"[english]dota_chatwheel_message_mirana_laugh"	"Ha ha ha ha ha ha!"
"dota_chatwheel_label_mirana_laugh"	"หัวเราะ"
"[english]dota_chatwheel_label_mirana_laugh"	"Laugh"
"dota_chatwheel_message_mirana_thank"	"ของขวัญยามราตรี!"
"[english]dota_chatwheel_message_mirana_thank"	"A gift from the night!"
"dota_chatwheel_label_mirana_thank"	"ของขวัญยามราตรี!"
"[english]dota_chatwheel_label_mirana_thank"	"A gift from the night!"
"dota_chatwheel_message_mirana_deny"	"แน่จริงก็จับให้ได้!"
"[english]dota_chatwheel_message_mirana_deny"	"Catch us if you can!"
"dota_chatwheel_label_mirana_deny"	"แน่จริงก็จับให้ได้!"
"[english]dota_chatwheel_label_mirana_deny"	"Catch us if you can!"
"dota_chatwheel_message_mirana_1"	"เจ้านี่ไม่รู้จักจำ"
"[english]dota_chatwheel_message_mirana_1"	"You have learned nothing."
"dota_chatwheel_label_mirana_1"	"เจ้านี่ไม่รู้จักจำ"
"[english]dota_chatwheel_label_mirana_1"	"You have learned nothing."
"dota_chatwheel_message_mirana_2"	"ทำได้ดี!"
"[english]dota_chatwheel_message_mirana_2"	"Nicely done!"
"dota_chatwheel_label_mirana_2"	"ทำได้ดี!"
"[english]dota_chatwheel_label_mirana_2"	"Nicely done!"
"dota_chatwheel_message_mirana_3"	"วิ่งหนีไปอย่างกับหมา!"
"[english]dota_chatwheel_message_mirana_3"	"Run like the dogs you are!"
"dota_chatwheel_label_mirana_3"	"วิ่งหนีไปอย่างกับหมา!"
"[english]dota_chatwheel_label_mirana_3"	"Run like the dogs you are!"
"dota_chatwheel_message_mirana_4"	"ตรงนี้ เหมี๋ยว-เหมียว-เหมียว...."
"[english]dota_chatwheel_message_mirana_4"	"Here, kitty-kitty-kitty...."
"dota_chatwheel_label_mirana_4"	"ตรงนี้ เหมี๋ยว-เหมียว-เหมียว...."
"[english]dota_chatwheel_label_mirana_4"	"Here, kitty-kitty-kitty...."
"dota_chatwheel_message_mirana_5"	"โชคช่วยซะที่ไหน ฝีมือต่างหาก!"
"[english]dota_chatwheel_message_mirana_5"	"It was not luck but skill!"
"dota_chatwheel_label_mirana_5"	"โชคช่วยซะที่ไหน ฝีมือต่างหาก!"
"[english]dota_chatwheel_label_mirana_5"	"It was not luck but skill!"
"dota_chatwheel_message_morphling_laugh"	"ฮ่า ฮ่า ฮ่า ฮ่า ฮ่า ฮ่า ฮ่า ฮ่า ฮ่า ฮ่า!"
"[english]dota_chatwheel_message_morphling_laugh"	"Ha ha ha ha ha ha ha ha ha ha!"
"dota_chatwheel_label_morphling_laugh"	"หัวเราะ"
"[english]dota_chatwheel_label_morphling_laugh"	"Laugh"
"dota_chatwheel_message_morphling_thank"	"ข้าชอบสิ่งที่ข้าเห็น"
"[english]dota_chatwheel_message_morphling_thank"	"I like what I see."
"dota_chatwheel_label_morphling_thank"	"ข้าชอบสิ่งที่ข้าเห็น"
"[english]dota_chatwheel_label_morphling_thank"	"I like what I see."
"dota_chatwheel_message_morphling_deny"	"เจ้านี่ยากเกินกว่าจะเข้าใจ"
"[english]dota_chatwheel_message_morphling_deny"	"You're in over your head."
"dota_chatwheel_label_morphling_deny"	"เจ้านี่ยากเกินกว่าจะเข้าใจ"
"[english]dota_chatwheel_label_morphling_deny"	"You're in over your head."
"dota_chatwheel_message_morphling_1"	"กำลังเดือดได้ที่!"
"[english]dota_chatwheel_message_morphling_1"	"Boiling rage!"
"dota_chatwheel_label_morphling_1"	"กำลังเดือดได้ที่!"
"[english]dota_chatwheel_label_morphling_1"	"Boiling rage!"
"dota_chatwheel_message_morphling_2"	"สดใสอยู่เสมอ"
"[english]dota_chatwheel_message_morphling_2"	"Always refreshing."
"dota_chatwheel_label_morphling_2"	"สดใสอยู่เสมอ"
"[english]dota_chatwheel_label_morphling_2"	"Always refreshing."
"dota_chatwheel_message_morphling_3"	"สถานการณ์ซัดกลับไปอีกฝั่ง!"
"[english]dota_chatwheel_message_morphling_3"	"The tide has turned!"
"dota_chatwheel_label_morphling_3"	"สถานการณ์ซัดกลับไปอีกฝั่ง!"
"[english]dota_chatwheel_label_morphling_3"	"The tide has turned!"
"dota_chatwheel_message_morphling_4"	"มองไม่เห็นคลื่นน้ำข้าหรือ?"
"[english]dota_chatwheel_message_morphling_4"	"Didn't you see me waving?"
"dota_chatwheel_label_morphling_4"	"มองไม่เห็นคลื่นน้ำข้าหรือ?"
"[english]dota_chatwheel_label_morphling_4"	"Didn't you see me waving?"
"dota_chatwheel_message_morphling_5"	"เจ้าช่างเหลวแหลก!"
"[english]dota_chatwheel_message_morphling_5"	"You're washed up!"
"dota_chatwheel_label_morphling_5"	"เจ้าช่างเหลวแหลก!"
"[english]dota_chatwheel_label_morphling_5"	"You're washed up!"
"dota_chatwheel_message_nevermore_laugh"	"ฮ้า ฮ่า ฮ่า ฮ่า ฮ่า ฮ่า!"
"[english]dota_chatwheel_message_nevermore_laugh"	"Ah ha ha ha ha ha!"
"dota_chatwheel_label_nevermore_laugh"	"หัวเราะ"
"[english]dota_chatwheel_label_nevermore_laugh"	"Laugh"
"dota_chatwheel_message_nevermore_thank"	"ขอวิญญาณยังสถิตอยู่กับเจ้า"
"[english]dota_chatwheel_message_nevermore_thank"	"Well bless your soul."
"dota_chatwheel_label_nevermore_thank"	"ขอวิญญาณยังสถิตอยู่กับเจ้า"
"[english]dota_chatwheel_label_nevermore_thank"	"Well bless your soul."
"dota_chatwheel_message_nevermore_deny"	"ข้าเหนือกว่า"
"[english]dota_chatwheel_message_nevermore_deny"	"Outplayed."
"dota_chatwheel_label_nevermore_deny"	"ข้าเหนือกว่า"
"[english]dota_chatwheel_label_nevermore_deny"	"Outplayed."
"dota_chatwheel_message_nevermore_1"	"วิญญาณงดงามควรค่าแก่การสะสม"
"[english]dota_chatwheel_message_nevermore_1"	"A beautiful soul for my collection."
"dota_chatwheel_label_nevermore_1"	"วิญญาณงดงามควรค่าแก่การสะสม"
"[english]dota_chatwheel_label_nevermore_1"	"A beautiful soul for my collection."
"dota_chatwheel_message_nevermore_2"	"จงหวาดเกรงการปรากฏกายของข้า"
"[english]dota_chatwheel_message_nevermore_2"	"Fear my presence."
"dota_chatwheel_label_nevermore_2"	"จงหวาดเกรงการปรากฏกายของข้า"
"[english]dota_chatwheel_label_nevermore_2"	"Fear my presence."
"dota_chatwheel_message_nevermore_3"	"ข้าจะรับไว้เอง"
"[english]dota_chatwheel_message_nevermore_3"	"I'll take it."
"dota_chatwheel_label_nevermore_3"	"ข้าจะรับไว้เอง"
"[english]dota_chatwheel_label_nevermore_3"	"I'll take it."
"dota_chatwheel_message_nevermore_4"	"เจ้ามิอาจหลบซ่อนได้!"
"[english]dota_chatwheel_message_nevermore_4"	"You can never hide!"
"dota_chatwheel_label_nevermore_4"	"เจ้ามิอาจหลบซ่อนได้!"
"[english]dota_chatwheel_label_nevermore_4"	"You can never hide!"
"dota_chatwheel_message_nevermore_5"	"Ozh icha gluth izh sol. (ข้าจักกลืนกินดวงวิญญาณเจ้า)"
"[english]dota_chatwheel_message_nevermore_5"	"Ozh icha gluth izh sol."
"dota_chatwheel_label_nevermore_5"	"ข้าจักกลืนกินดวงวิญญาณเจ้า"
"[english]dota_chatwheel_label_nevermore_5"	"Ozh icha gluth izh sol."
"dota_chatwheel_message_phantom_lancer_laugh"	"ฮ่า ฮ่า ฮ่า ฮ่า ฮ่า ฮ่า ฮ่า ฮ่า ฮ่า ฮ่า ฮ่า ฮ่า ฮ่า!"
"[english]dota_chatwheel_message_phantom_lancer_laugh"	"Ha ha ha ha ha ha ha ha ha ha ha ha ha!"
"dota_chatwheel_label_phantom_lancer_laugh"	"หัวเราะ"
"[english]dota_chatwheel_label_phantom_lancer_laugh"	"Laugh"
"dota_chatwheel_message_phantom_lancer_thank"	"น่ามหัศจรรย์อะไรเยี่ยงนี้"
"[english]dota_chatwheel_message_phantom_lancer_thank"	"What an amazing thing."
"dota_chatwheel_label_phantom_lancer_thank"	"น่ามหัศจรรย์อะไรเยี่ยงนี้"
"[english]dota_chatwheel_label_phantom_lancer_thank"	"What an amazing thing."
"dota_chatwheel_message_phantom_lancer_deny"	"เพียงใช้สมาธิ"
"[english]dota_chatwheel_message_phantom_lancer_deny"	"Such simple minds."
"dota_chatwheel_label_phantom_lancer_deny"	"เพียงใช้สมาธิ"
"[english]dota_chatwheel_label_phantom_lancer_deny"	"Such simple minds."
"dota_chatwheel_message_phantom_lancer_1"	"พวกเรามาเพื่อท่าน!"
"[english]dota_chatwheel_message_phantom_lancer_1"	"We come for you!"
"dota_chatwheel_label_phantom_lancer_1"	"พวกเรามาเพื่อท่าน!"
"[english]dota_chatwheel_label_phantom_lancer_1"	"We come for you!"
"dota_chatwheel_message_phantom_lancer_2"	"นี่ก็งี่เงาสิ้นดี"
"[english]dota_chatwheel_message_phantom_lancer_2"	"Now this is just silly."
"dota_chatwheel_label_phantom_lancer_2"	"นี่ก็งี่เงาสิ้นดี"
"[english]dota_chatwheel_label_phantom_lancer_2"	"Now this is just silly."
"dota_chatwheel_message_phantom_lancer_3"	"พวกเราจะมีจำนวนเยอะกว่าเดิม"
"[english]dota_chatwheel_message_phantom_lancer_3"	"We have more where that came from."
"dota_chatwheel_label_phantom_lancer_3"	"พวกเราจะมีจำนวนเยอะกว่าเดิม"
"[english]dota_chatwheel_label_phantom_lancer_3"	"We have more where that came from."
"dota_chatwheel_message_phantom_lancer_4"	"จำนวนทำให้สำเร็จผล ลำพังกลยุทธ์มิอาจทำได้"
"[english]dota_chatwheel_message_phantom_lancer_4"	"Numbers have accomplished what strategy alone could not."
"dota_chatwheel_label_phantom_lancer_4"	"จำนวนทำให้สำเร็จผล..."
"[english]dota_chatwheel_label_phantom_lancer_4"	"Numbers have accomplished..."
"dota_chatwheel_message_phantom_lancer_5"	"พวกเรามีจำนวนเยอะกว่าท่าน เยอะกว่าพวกท่านทั้งหมด!"
"[english]dota_chatwheel_message_phantom_lancer_5"	"We outnumbered you. We outnumber them all!"
"dota_chatwheel_label_phantom_lancer_5"	"พวกเรามีจำนวนเยอะกว่าท่าน..."
"[english]dota_chatwheel_label_phantom_lancer_5"	"We outnumbered you..."
"dota_chatwheel_message_puck_laugh"	"ฮ่า ฮ่า!"
"[english]dota_chatwheel_message_puck_laugh"	"Ha ha!"
"dota_chatwheel_label_puck_laugh"	"หัวเราะ"
"[english]dota_chatwheel_label_puck_laugh"	"Laugh"
"dota_chatwheel_message_puck_thank"	"น่าสนใจดีนะ"
"[english]dota_chatwheel_message_puck_thank"	"Interesting."
"dota_chatwheel_label_puck_thank"	"น่าสนใจดีนะ"
"[english]dota_chatwheel_label_puck_thank"	"Interesting."
"dota_chatwheel_message_puck_deny"	"คุณคงคิดอยากย้อนกลับไปแก้ไขเมื่อกี้ใช่ไหมล่ะ"
"[english]dota_chatwheel_message_puck_deny"	"You might wish to retract your last move."
"dota_chatwheel_label_puck_deny"	"คุณคงคิดอยากย้อนกลับ..."
"[english]dota_chatwheel_label_puck_deny"	"You might wish to retract..."
"dota_chatwheel_message_puck_1"	"สวัสดีจ้า!"
"[english]dota_chatwheel_message_puck_1"	"Greetings!"
"dota_chatwheel_label_puck_1"	"สวัสดีจ้า!"
"[english]dota_chatwheel_label_puck_1"	"Greetings!"
"dota_chatwheel_message_puck_2"	"นี่มันอะไร เกมชนิดนึงเหรอ?"
"[english]dota_chatwheel_message_puck_2"	"What is this, a game of some sort?"
"dota_chatwheel_label_puck_2"	"นี่มันอะไร เกมชนิดนึงเหรอ?"
"[english]dota_chatwheel_label_puck_2"	"What is this, a game of some sort?"
"dota_chatwheel_message_puck_3"	"โศกนาฏกรรมอันยิ่งใหญ่ในยุคเรา"
"[english]dota_chatwheel_message_puck_3"	"The greatest tragedy of our eon."
"dota_chatwheel_label_puck_3"	"โศกนาฏกรรมอันยิ่งใหญ่ในยุคเรา"
"[english]dota_chatwheel_label_puck_3"	"The greatest tragedy of our eon."
"dota_chatwheel_message_puck_4"	"เมื่อกี้ฉลาดหรือเปล่า?"
"[english]dota_chatwheel_message_puck_4"	"Was that smart?"
"dota_chatwheel_label_puck_4"	"เมื่อกี้ฉลาดหรือเปล่า?"
"[english]dota_chatwheel_label_puck_4"	"Was that smart?"
"dota_chatwheel_message_puck_5"	"ความรู้สึกนี้มันไม่คุ้นเลย ใช่ดีใจรึเปล่าอะ?"
"[english]dota_chatwheel_message_puck_5"	"I am unfamiliar with this feeling. Is it joy?"
"dota_chatwheel_label_puck_5"	"ความรู้สึกนี้มันไม่คุ้นเลย..."
"[english]dota_chatwheel_label_puck_5"	"I am unfamiliar with this feeling..."
"dota_chatwheel_message_pudge_laugh"	"ฮื้ม ฮื้ม ฮื้ม ฮื้ม ฮ่า ฮ่า ฮ่า"
"[english]dota_chatwheel_message_pudge_laugh"	"Hm hm hm hm ha ha ha."
"dota_chatwheel_label_pudge_laugh"	"หัวเราะ"
"[english]dota_chatwheel_label_pudge_laugh"	"Laugh"
"dota_chatwheel_message_pudge_thank"	"ก็น่าพอใจนิดหน่อย"
"[english]dota_chatwheel_message_pudge_thank"	"That's a bit of all right."
"dota_chatwheel_label_pudge_thank"	"ก็น่าพอใจนิดหน่อย"
"[english]dota_chatwheel_label_pudge_thank"	"That's a bit of all right."
"dota_chatwheel_message_pudge_deny"	"โอ๊ะ ฝีมือข้าเองเรอะ?"
"[english]dota_chatwheel_message_pudge_deny"	"Oops. Was that me?"
"dota_chatwheel_label_pudge_deny"	"โอ๊ะ ฝีมือข้าเองเรอะ?"
"[english]dota_chatwheel_label_pudge_deny"	"Oops. Was that me?"
"dota_chatwheel_message_pudge_1"	"ได้เวลาชำแหละเนื้อสักหน่อย!"
"[english]dota_chatwheel_message_pudge_1"	"Time for a little butchery!"
"dota_chatwheel_label_pudge_1"	"ได้เวลาชำแหละเนื้อสักหน่อย!"
"[english]dota_chatwheel_label_pudge_1"	"Time for a little butchery!"
"dota_chatwheel_message_pudge_2"	"ไม่มีอะไรดีไปกว่าตับสดใหม่"
"[english]dota_chatwheel_message_pudge_2"	"Nothing better than a nice raw liver."
"dota_chatwheel_label_pudge_2"	"ไม่มีอะไรดีไปกว่าตับสดใหม่"
"[english]dota_chatwheel_label_pudge_2"	"Nothing better than a nice raw liver."
"dota_chatwheel_message_pudge_3"	"ไงก็ได้"
"[english]dota_chatwheel_message_pudge_3"	"Whateva."
"dota_chatwheel_label_pudge_3"	"ไงก็ได้"
"[english]dota_chatwheel_label_pudge_3"	"Whateva."
"dota_chatwheel_message_pudge_4"	"อร่อยถูกปาก..."
"[english]dota_chatwheel_message_pudge_4"	"Delicious..."
"dota_chatwheel_label_pudge_4"	"อร่อยถูกปาก..."
"[english]dota_chatwheel_label_pudge_4"	"Delicious..."
"dota_chatwheel_message_pudge_5"	"เอาไปเสียบเหล็กย่างอีกสักหน่อย แกคงดูดีขึ้น!"
"[english]dota_chatwheel_message_pudge_5"	"You'll look good with an apple in yer mouth!"
"dota_chatwheel_label_pudge_5"	"เอาไปเสียบเหล็กย่าง..."
"[english]dota_chatwheel_label_pudge_5"	"You'll look good with..."
"dota_chatwheel_message_razor_laugh"	"ฮ้า ฮ่า ฮ่า ฮ่า ฮ่า ฮ่า ฮ่า ฮ่า ฮ่า"
"[english]dota_chatwheel_message_razor_laugh"	"Ah ha ha ha ha ha ha ha ha."
"dota_chatwheel_label_razor_laugh"	"หัวเราะ"
"[english]dota_chatwheel_label_razor_laugh"	"Laugh"
"dota_chatwheel_message_razor_thank"	"ข้าสัมผัสถึงความสัมพันธ์ระหว่างเรา!"
"[english]dota_chatwheel_message_razor_thank"	"I sense a connection between us!"
"dota_chatwheel_label_razor_thank"	"ข้าสัมผัสถึงความสัมพันธ์ระหว่างเรา!"
"[english]dota_chatwheel_label_razor_thank"	"I sense a connection between us!"
"dota_chatwheel_message_razor_deny"	"จะหนีไปก็ได้ แต่แกหนีไปก็จะดีกว่า"
"[english]dota_chatwheel_message_razor_deny"	"You can run. You should run."
"dota_chatwheel_label_razor_deny"	"จะหนีไปก็ได้ แต่แกหนีไปก็จะดีกว่า"
"[english]dota_chatwheel_label_razor_deny"	"You can run. You should run."
"dota_chatwheel_message_razor_1"	"แกตายแล้ว ตายน่ะ"
"[english]dota_chatwheel_message_razor_1"	"You are dead. Dead."
"dota_chatwheel_label_razor_1"	"แกตายแล้ว ตายน่ะ"
"[english]dota_chatwheel_label_razor_1"	"You are dead. Dead."
"dota_chatwheel_message_razor_2"	"เถ้าธุลีแกจะตกลงดั่งสายฝน"
"[english]dota_chatwheel_message_razor_2"	"Your ashes will fall like rain."
"dota_chatwheel_label_razor_2"	"เถ้าธุลีแกจะตกลงดั่งสายฝน"
"[english]dota_chatwheel_label_razor_2"	"Your ashes will fall like rain."
"dota_chatwheel_message_razor_3"	"ช็อกละสิ"
"[english]dota_chatwheel_message_razor_3"	"Shocking."
"dota_chatwheel_label_razor_3"	"ช็อกละสิ"
"[english]dota_chatwheel_label_razor_3"	"Shocking."
"dota_chatwheel_message_razor_4"	"นี่จะทำให้เจ็บปวดไปชั่วนิจนิรันดร์"
"[english]dota_chatwheel_message_razor_4"	"This will only hurt forever."
"dota_chatwheel_label_razor_4"	"นี่จะทำให้เจ็บปวดไปชั่วนิจนิรันดร์"
"[english]dota_chatwheel_label_razor_4"	"This will only hurt forever."
"dota_chatwheel_message_razor_5"	"แกแสบก้นไหมล่ะ!"
"[english]dota_chatwheel_message_razor_5"	"Zapped your ass!"
"dota_chatwheel_label_razor_5"	"แกแสบก้นไหมล่ะ!"
"[english]dota_chatwheel_label_razor_5"	"Zapped your ass!"
"dota_chatwheel_message_sand_king_laugh"	"ฮ่า ฮ่า ฮ่า ฮ่า ฮ่า ฮ่า ฮ่า!"
"[english]dota_chatwheel_message_sand_king_laugh"	"Ha ha ha ha ha ha ha!"
"dota_chatwheel_label_sand_king_laugh"	"หัวเราะ"
"[english]dota_chatwheel_label_sand_king_laugh"	"Laugh"
"dota_chatwheel_message_sand_king_thank"	"เจ้าได้สร้างผลงานอันยอดเยี่ยมแล้ว"
"[english]dota_chatwheel_message_sand_king_thank"	"You have done a great service."
"dota_chatwheel_label_sand_king_thank"	"เจ้าได้สร้างผลงานอันยอดเยี่ยมแล้ว"
"[english]dota_chatwheel_label_sand_king_thank"	"You have done a great service."
"dota_chatwheel_message_sand_king_deny"	"เจ็บแสบ ใช่ไหมละ?"
"[english]dota_chatwheel_message_sand_king_deny"	"Stings, don't it?"
"dota_chatwheel_label_sand_king_deny"	"เจ็บแสบ ใช่ไหมละ?"
"[english]dota_chatwheel_label_sand_king_deny"	"Stings, don't it?"
"dota_chatwheel_message_sand_king_1"	"โค้งคำนับแก่นายของเจ้าซะ"
"[english]dota_chatwheel_message_sand_king_1"	"Bow to your liege."
"dota_chatwheel_label_sand_king_1"	"โค้งคำนับแก่นายของเจ้าซะ"
"[english]dota_chatwheel_label_sand_king_1"	"Bow to your liege."
"dota_chatwheel_message_sand_king_2"	"ชัยช-ช-ชนะแห่งผืนทราย!"
"[english]dota_chatwheel_message_sand_king_2"	"A Sandy V-V-Victory!"
"dota_chatwheel_label_sand_king_2"	"ชัยช-ช-ชนะแห่งผืนทราย!"
"[english]dota_chatwheel_label_sand_king_2"	"A Sandy V-V-Victory!"
"dota_chatwheel_message_sand_king_3"	"เจ้าคิดว่าเจ้ากำลังจะไปไหนน่ะ?"
"[english]dota_chatwheel_message_sand_king_3"	"Where do you think you're going?"
"dota_chatwheel_label_sand_king_3"	"เจ้าคิดว่าเจ้ากำลังจะไปไหนน่ะ?"
"[english]dota_chatwheel_label_sand_king_3"	"Where do you think you're going?"
"dota_chatwheel_message_sand_king_4"	"เจ้านึกว่าจะได้...ฝันดีเห็นมนุษย์ทรายงั้นรึ?"
"[english]dota_chatwheel_message_sand_king_4"	"You were expecting...Sandy Claws?"
"dota_chatwheel_label_sand_king_4"	"เจ้านึกว่าจะได้ฝันดีเห็นมนุษย์ทรายงั้นรึ?"
"[english]dota_chatwheel_label_sand_king_4"	"You were expecting Sandy Claws?"
"dota_chatwheel_message_sand_king_5"	"ดีที่ข้าได้เป็นถึงกษัตริย์!"
"[english]dota_chatwheel_message_sand_king_5"	"It's good to be King!"
"dota_chatwheel_label_sand_king_5"	"ดีที่ข้าได้เป็นถึงกษัตริย์"
"[english]dota_chatwheel_label_sand_king_5"	"It's good to be King"
"dota_chatwheel_message_storm_spirit_laugh"	"ฮื้ม ฮื้ม ฮื้ม ฮื้ม ฮื่อ ฮื่อ ฮื่อ ฮ่า ฮ่า"
"[english]dota_chatwheel_message_storm_spirit_laugh"	"Hm hm hm hm hee hee hee ha ha."
"dota_chatwheel_label_storm_spirit_laugh"	"หัวเราะ"
"[english]dota_chatwheel_label_storm_spirit_laugh"	"Laugh"
"dota_chatwheel_message_storm_spirit_thank"	"นั่นแหละน้ำใจ!"
"[english]dota_chatwheel_message_storm_spirit_thank"	"That's the spirit!"
"dota_chatwheel_label_storm_spirit_thank"	"นั่นแหละน้ำใจ!"
"[english]dota_chatwheel_label_storm_spirit_thank"	"That's the spirit!"
"dota_chatwheel_message_storm_spirit_deny"	"เจ้าพลาดแล้ว!"
"[english]dota_chatwheel_message_storm_spirit_deny"	"You blew it!"
"dota_chatwheel_label_storm_spirit_deny"	"เจ้าพลาดแล้ว!"
"[english]dota_chatwheel_label_storm_spirit_deny"	"You blew it!"
"dota_chatwheel_message_storm_spirit_1"	"ข้าชื่นชอบบริเวณนี้เสียจริง!"
"[english]dota_chatwheel_message_storm_spirit_1"	"I love this part!"
"dota_chatwheel_label_storm_spirit_1"	"ข้าชื่นชอบบริเวณนี้เสียจริง!"
"[english]dota_chatwheel_label_storm_spirit_1"	"I love this part!"
"dota_chatwheel_message_storm_spirit_2"	"มองหาข้ารึ?"
"[english]dota_chatwheel_message_storm_spirit_2"	"Lookin for me?"
"dota_chatwheel_label_storm_spirit_2"	"มองหาข้ารึ?"
"[english]dota_chatwheel_label_storm_spirit_2"	"Lookin for me?"
"dota_chatwheel_message_storm_spirit_3"	"ข้าบอกเจ้าแล้วมรสุมกำลังถาโถมเข้ามา!"
"[english]dota_chatwheel_message_storm_spirit_3"	"Told you a storm was coming!"
"dota_chatwheel_label_storm_spirit_3"	"ข้าบอกเจ้าแล้วมรสุมกำลังถาโถมเข้ามา!"
"[english]dota_chatwheel_label_storm_spirit_3"	"Told you a storm was coming!"
"dota_chatwheel_message_storm_spirit_4"	"ช่างดูดีเสียจริง!"
"[english]dota_chatwheel_message_storm_spirit_4"	"Looking good!"
"dota_chatwheel_label_storm_spirit_4"	"ช่างดูดีเสียจริง!"
"[english]dota_chatwheel_label_storm_spirit_4"	"Looking good!"
"dota_chatwheel_message_storm_spirit_5"	"ช่างเปล่งปลั่ง!"
"[english]dota_chatwheel_message_storm_spirit_5"	"Glorious!"
"dota_chatwheel_label_storm_spirit_5"	"ช่างเปล่งปลั่ง!"
"[english]dota_chatwheel_label_storm_spirit_5"	"Glorious!"
"dota_chatwheel_message_sven_laugh"	"ฮ้าา ฮ่า ฮ่า ฮ่า! ฮ่า ฮ่า ฮ่า ฮ่า!"
"[english]dota_chatwheel_message_sven_laugh"	"Ahh ha ha ha! Ha ha ha ha!"
"dota_chatwheel_label_sven_laugh"	"หัวเราะ"
"[english]dota_chatwheel_label_sven_laugh"	"Laugh"
"dota_chatwheel_message_sven_thank"	"มิตรแท้คือคนอย่างเจ้า"
"[english]dota_chatwheel_message_sven_thank"	"You are a true friend."
"dota_chatwheel_label_sven_thank"	"มิตรแท้คือคนอย่างเจ้า"
"[english]dota_chatwheel_label_sven_thank"	"You are a true friend."
"dota_chatwheel_message_sven_deny"	"เหมือนเจ้าจะโดนสตันนะ"
"[english]dota_chatwheel_message_sven_deny"	"You look stunned."
"dota_chatwheel_label_sven_deny"	"เหมือนเจ้าจะโดนสตันนะ"
"[english]dota_chatwheel_label_sven_deny"	"You look stunned."
"dota_chatwheel_message_sven_1"	"Rogue Knight เก็บไปอีกหนึ่ง"
"[english]dota_chatwheel_message_sven_1"	"Rogue Knight claims another."
"dota_chatwheel_label_sven_1"	"Rogue Knight เก็บไปอีกหนึ่ง"
"[english]dota_chatwheel_label_sven_1"	"Rogue Knight claims another."
"dota_chatwheel_message_sven_2"	"สาสมแก่ตัวเจ้าแล้วล่ะ"
"[english]dota_chatwheel_message_sven_2"	"You deserved it."
"dota_chatwheel_label_sven_2"	"สาสมแก่ตัวเจ้าแล้วล่ะ"
"[english]dota_chatwheel_label_sven_2"	"You deserved it."
"dota_chatwheel_message_sven_3"	"เกียรติยศของข้าค้ำคอข้า...สู่ความฮึกเหิม"
"[english]dota_chatwheel_message_sven_3"	"My honor compels me...to gloat."
"dota_chatwheel_label_sven_3"	"เกียรติยศของข้าค้ำคอข้า...สู่ความฮึกเหิม"
"[english]dota_chatwheel_label_sven_3"	"My honor compels me...to gloat."
"dota_chatwheel_message_sven_4"	"ผลลัพธ์ดั่งที่ข้าหวัง"
"[english]dota_chatwheel_message_sven_4"	"An expected outcome."
"dota_chatwheel_label_sven_4"	"ผลลัพธ์ดั่งที่ข้าหวัง"
"[english]dota_chatwheel_label_sven_4"	"An expected outcome."
"dota_chatwheel_message_sven_5"	"อืม...จากเมื่อตะกี้ เราได้รู้อะไรไปบ้าง"
"[english]dota_chatwheel_message_sven_5"	"Hm...now what do we learn from this."
"dota_chatwheel_label_sven_5"	"อืม...จากเมื่อตะกี้ เราได้รู้อะไรไปบ้าง"
"[english]dota_chatwheel_label_sven_5"	"Hm...now what do we learn from this."
"dota_chatwheel_message_tiny_laugh"	"ฮี่ฮี่ฮี่ฮี่ฮื้อฮี่ฮี่ฮี่"
"[english]dota_chatwheel_message_tiny_laugh"	"Hehehehehuhhehehe."
"dota_chatwheel_label_tiny_laugh"	"หัวเราะ"
"[english]dota_chatwheel_label_tiny_laugh"	"Laugh"
"dota_chatwheel_message_tiny_thank"	"เจ้าพร้อมเอาหินไปสู้แล้วรึยัง?"
"[english]dota_chatwheel_message_tiny_thank"	"Are you ready to rubble?"
"dota_chatwheel_label_tiny_thank"	"เจ้าพร้อมเอาหินไปสู้แล้วรึยัง?"
"[english]dota_chatwheel_label_tiny_thank"	"Are you ready to rubble?"
"dota_chatwheel_message_tiny_deny"	"เอ่อ เจ้าดูนั่นสิ"
"[english]dota_chatwheel_message_tiny_deny"	"Well, look at that."
"dota_chatwheel_label_tiny_deny"	"เอ่อ เจ้าดูนั่นสิ"
"[english]dota_chatwheel_label_tiny_deny"	"Well, look at that."
"dota_chatwheel_message_tiny_1"	"ข่มมัน บดขยี้มัน!"
"[english]dota_chatwheel_message_tiny_1"	"Rock em, sock em!"
"dota_chatwheel_label_tiny_1"	"ข่มมัน บดขยี้มัน!"
"[english]dota_chatwheel_label_tiny_1"	"Rock em, sock em!"
"dota_chatwheel_message_tiny_2"	"เจ้าหัวโนแล้วน่ะ"
"[english]dota_chatwheel_message_tiny_2"	"You got rocks in your head."
"dota_chatwheel_label_tiny_2"	"เจ้าหัวโนแล้วน่ะ"
"[english]dota_chatwheel_label_tiny_2"	"You got rocks in your head."
"dota_chatwheel_message_tiny_3"	"ข้าต้องขออภัย"
"[english]dota_chatwheel_message_tiny_3"	"My apologies."
"dota_chatwheel_label_tiny_3"	"ข้าต้องขออภัย"
"[english]dota_chatwheel_label_tiny_3"	"My apologies."
"dota_chatwheel_message_tiny_4"	"เจ้ายังมิได้รับหินจากข้าเลย"
"[english]dota_chatwheel_message_tiny_4"	"You haven't got the stones."
"dota_chatwheel_label_tiny_4"	"เจ้ายังมิได้รับหินจากข้าเลย"
"[english]dota_chatwheel_label_tiny_4"	"You haven't got the stones."
"dota_chatwheel_message_tiny_5"	"ก็ยากนะถึงจะทำได้ดีเช่นนี้"
"[english]dota_chatwheel_message_tiny_5"	"It's hard to be this good."
"dota_chatwheel_label_tiny_5"	"ก็ยากนะถึงจะทำได้ดีเช่นนี้"
"[english]dota_chatwheel_label_tiny_5"	"It's hard to be this good."
"dota_chatwheel_message_vengefulspirit_laugh"	"ฮื้ม ฮ่า ฮ่า ฮ่า ฮ่า ฮ่า ฮ่า!"
"[english]dota_chatwheel_message_vengefulspirit_laugh"	"Hm ha ha ha ha ha ha!"
"dota_chatwheel_label_vengefulspirit_laugh"	"หัวเราะ"
"[english]dota_chatwheel_label_vengefulspirit_laugh"	"Laugh"
"dota_chatwheel_message_vengefulspirit_thank"	"ช่างมีน้ำใจ..."
"[english]dota_chatwheel_message_vengefulspirit_thank"	"So sweet..."
"dota_chatwheel_label_vengefulspirit_thank"	"ช่างมีน้ำใจ..."
"[english]dota_chatwheel_label_vengefulspirit_thank"	"So sweet..."
"dota_chatwheel_message_vengefulspirit_deny"	"อะไร...?"
"[english]dota_chatwheel_message_vengefulspirit_deny"	"What...?"
"dota_chatwheel_label_vengefulspirit_deny"	"อะไร...?"
"[english]dota_chatwheel_label_vengefulspirit_deny"	"What...?"
"dota_chatwheel_message_vengefulspirit_1"	"ข้ารู้สึกดีขึ้นแล้ว"
"[english]dota_chatwheel_message_vengefulspirit_1"	"I feel better already."
"dota_chatwheel_label_vengefulspirit_1"	"ข้ารู้สึกดีขึ้นแล้ว"
"[english]dota_chatwheel_label_vengefulspirit_1"	"I feel better already."
"dota_chatwheel_message_vengefulspirit_2"	"สลับที่!"
"[english]dota_chatwheel_message_vengefulspirit_2"	"Swapsies!"
"dota_chatwheel_label_vengefulspirit_2"	"สลับที่!"
"[english]dota_chatwheel_label_vengefulspirit_2"	"Swapsies!"
"dota_chatwheel_message_vengefulspirit_3"	"มว๊าอะฮ่ะฮาฮ่าฮ่าฮ่าฮ่าฮ่าฮา!"
"[english]dota_chatwheel_message_vengefulspirit_3"	"Mwahahhahahahahahaha!"
"dota_chatwheel_label_vengefulspirit_3"	"มว๊าอะฮ่ะฮาฮ่าฮ่าฮ่าฮ่าฮ่าฮา!"
"[english]dota_chatwheel_label_vengefulspirit_3"	"Mwahahhahahahahahaha!"
"dota_chatwheel_message_vengefulspirit_4"	"จงเตรียมใจรับคลื่นอันน่าสะพรึงกลัวเสียเถอะ: บู!"
"[english]dota_chatwheel_message_vengefulspirit_4"	"Prepare for the wave of terror: boo!"
"dota_chatwheel_label_vengefulspirit_4"	"จงเตรียมใจรับคลื่นอันน่าสะพรึงกลัวเสียเถอะ: บู!"
"[english]dota_chatwheel_label_vengefulspirit_4"	"Prepare for the wave of terror: boo!"
"dota_chatwheel_message_vengefulspirit_5"	"ความเจ็บปวดของเหล่าศัตรูของข้า เป็นสิ่งเดียวที่หลงเหลือให้ข้าปิติ"
"[english]dota_chatwheel_message_vengefulspirit_5"	"The pain of my enemies is the only pleasure left to me."
"dota_chatwheel_label_vengefulspirit_5"	"ความเจ็บปวดของเหล่าศัตรูของข้า..."
"[english]dota_chatwheel_label_vengefulspirit_5"	"The pain of my enemies..."
"dota_chatwheel_message_windrunner_laugh"	"ฮ่าา-ฮ่า-ฮ่า-ฮ่า-ฮ่า!"
"[english]dota_chatwheel_message_windrunner_laugh"	"Hah-ha-ha-ha-ha!"
"dota_chatwheel_label_windrunner_laugh"	"หัวเราะ"
"[english]dota_chatwheel_label_windrunner_laugh"	"Laugh"
"dota_chatwheel_message_windrunner_thank"	"สดชื่นราบรื่นจังเลย"
"[english]dota_chatwheel_message_windrunner_thank"	"Easy breezy"
"dota_chatwheel_label_windrunner_thank"	"สดชื่นราบรื่นจังเลย"
"[english]dota_chatwheel_label_windrunner_thank"	"Easy breezy"
"dota_chatwheel_message_windrunner_deny"	"ฉันไม่คิดอย่างนั้นนะ"
"[english]dota_chatwheel_message_windrunner_deny"	"I don't think so."
"dota_chatwheel_label_windrunner_deny"	"ฉันไม่คิดอย่างนั้นนะ"
"[english]dota_chatwheel_label_windrunner_deny"	"I don't think so."
"dota_chatwheel_message_windrunner_1"	"อาจจะแย่หน่อยนะ โอ้ ช้าก่อน ไม่ ก็ไม่แย่เลยนะ"
"[english]dota_chatwheel_message_windrunner_1"	"Could be worse. Oh, wait, no it couldn't."
"dota_chatwheel_label_windrunner_1"	"อาจจะแย่หน่อยนะ..."
"[english]dota_chatwheel_label_windrunner_1"	"Could be worse..."
"dota_chatwheel_message_windrunner_2"	"เธอจะไปไหนไม่ได้ทั้งนั้น"
"[english]dota_chatwheel_message_windrunner_2"	"You're not going anywhere."
"dota_chatwheel_label_windrunner_2"	"เธอจะไปไหนไม่ได้ทั้งนั้น"
"[english]dota_chatwheel_label_windrunner_2"	"You're not going anywhere."
"dota_chatwheel_message_windrunner_3"	"ถ้าเธอยังไม่ยอมตายซะโดยดี ฉันจะระดมยิงเธออีกระลอก"
"[english]dota_chatwheel_message_windrunner_3"	"If you weren't so damned dead, I'd shoot you again."
"dota_chatwheel_label_windrunner_3"	"ถ้าเธอยังไม่ยอมตายซะโดยดี..."
"[english]dota_chatwheel_label_windrunner_3"	"If you weren't so damned dead..."
"dota_chatwheel_message_windrunner_4"	"บอกฉันทีว่านี่มันไม่ใช่เรื่องจริง"
"[english]dota_chatwheel_message_windrunner_4"	"Tell me this did not just happen."
"dota_chatwheel_label_windrunner_4"	"บอกฉันทีว่านี่มันไม่ใช่เรื่องจริง"
"[english]dota_chatwheel_label_windrunner_4"	"Tell me this did not just happen."
"dota_chatwheel_message_windrunner_5"	"ฉันส่งจูบให้เธอนะ"
"[english]dota_chatwheel_message_windrunner_5"	"I blow you a kiss."
"dota_chatwheel_label_windrunner_5"	"ฉันส่งจูบให้เธอนะ"
"[english]dota_chatwheel_label_windrunner_5"	"I blow you a kiss."
"dota_chatwheel_message_zuus_laugh"	"ฮ่า ฮ่า ฮ่า ฮ่า ฮ่า ฮ่า ฮ่า ฮ่า ฮ่า!"
"[english]dota_chatwheel_message_zuus_laugh"	"Ha ha ha ha ha ha ha ha ha!"
"dota_chatwheel_label_zuus_laugh"	"หัวเราะ"
"[english]dota_chatwheel_label_zuus_laugh"	"Laugh"
"dota_chatwheel_message_zuus_thank"	"ด้วยเกียรติแห่งข้า เจ้าทำได้ดี!"
"[english]dota_chatwheel_message_zuus_thank"	"By my whiskers, that's good stuff!"
"dota_chatwheel_label_zuus_thank"	"เจ้าทำได้ดี!"
"[english]dota_chatwheel_label_zuus_thank"	"That's good stuff!"
"dota_chatwheel_message_zuus_deny"	"ฮึ ฮะ ฮ่ะ ฮ่ะ ฮ่า แล้วเจ้าคิดไว้ว่าจะเป็นเช่นไรรึ?"
"[english]dota_chatwheel_message_zuus_deny"	"Ha ha ha ha ha. Well what did you expect?"
"dota_chatwheel_label_zuus_deny"	"แล้วเจ้าคิดไว้ว่าจะเป็นเช่นไรรึ?"
"[english]dota_chatwheel_label_zuus_deny"	"Well what did you expect?"
"dota_chatwheel_message_zuus_1"	"รอสักนิด!"
"[english]dota_chatwheel_message_zuus_1"	"Wait for it!"
"dota_chatwheel_label_zuus_1"	"รอสักนิด!"
"[english]dota_chatwheel_label_zuus_1"	"Wait for it!"
"dota_chatwheel_message_zuus_2"	"โดนแค่นี้ก็ตายแล้วหรือ?"
"[english]dota_chatwheel_message_zuus_2"	"That's all it takes to kill you?"
"dota_chatwheel_label_zuus_2"	"โดนแค่นี้ก็..?"
"[english]dota_chatwheel_label_zuus_2"	"That's all it takes..?"
"dota_chatwheel_message_zuus_3"	"โอ้...นี่ท่าจะไม่ดีเสียแล้ว"
"[english]dota_chatwheel_message_zuus_3"	"Oh...this can't be good."
"dota_chatwheel_label_zuus_3"	"นี่ท่าจะไม่ดีเสียแล้ว"
"[english]dota_chatwheel_label_zuus_3"	"This can't be good"
"dota_chatwheel_message_zuus_4"	"เสียงฟ้าผ่าดังสนั่นลั่นทุ่ง!"
"[english]dota_chatwheel_message_zuus_4"	"Thund'rous applause!"
"dota_chatwheel_label_zuus_4"	"เสียงฟ้าผ่าดังสนั่นลั่นทุ่ง!"
"[english]dota_chatwheel_label_zuus_4"	"Thund'rous applause!"
"dota_chatwheel_message_zuus_5"	"เจ้าคิดว่าจะหลบซ่อนจากเทพเจ้าได้งั้นรึ?"
"[english]dota_chatwheel_message_zuus_5"	"Did you think you could hide from a god?"
"dota_chatwheel_label_zuus_5"	"เจ้าคิดว่าจะหลบซ่อนได้งั้นรึ?"
"[english]dota_chatwheel_label_zuus_5"	"Did you think you could hide?"
"dota_chatwheel_message_kunkka_laugh"	"ฮี่-ฮู่-ฮู่-ฮู่-ฮู่-ฮื้อฮู่ฮ่า!"
"[english]dota_chatwheel_message_kunkka_laugh"	"He-hu-hu-hu-hu-huhhuha!"
"dota_chatwheel_label_kunkka_laugh"	"หัวเราะ"
"[english]dota_chatwheel_label_kunkka_laugh"	"Laugh"
"dota_chatwheel_message_kunkka_thank"	"เจ้าเป็นผู้ช่วยนายเรือที่ไว้วางใจได้!"
"[english]dota_chatwheel_message_kunkka_thank"	"You're a trusty mate!"
"dota_chatwheel_label_kunkka_thank"	"เจ้าเป็นผู้ช่วยนายเรือที่ไว้วางใจได้!"
"[english]dota_chatwheel_label_kunkka_thank"	"You're a trusty mate!"
"dota_chatwheel_message_kunkka_deny"	"จมดิ่งลงก้นมหาสมุทรไปซะ!"
"[english]dota_chatwheel_message_kunkka_deny"	"Straight to the bottom with ya!"
"dota_chatwheel_label_kunkka_deny"	"จมดิ่งลงก้นมหาสมุทรไปซะ!"
"[english]dota_chatwheel_label_kunkka_deny"	"Straight to the bottom with ya!"
"dota_chatwheel_message_kunkka_1"	"เจ้ามันไม่มีความอาจหาญ"
"[english]dota_chatwheel_message_kunkka_1"	"You don't have the sand."
"dota_chatwheel_label_kunkka_1"	"เจ้ามันไม่มีความอาจหาญ"
"[english]dota_chatwheel_label_kunkka_1"	"You don't have the sand."
"dota_chatwheel_message_kunkka_2"	"เหอะ! มีคนตกเรือ!"
"[english]dota_chatwheel_message_kunkka_2"	"Heh! Man overboard!"
"dota_chatwheel_label_kunkka_2"	"เหอะ! มีคนตกเรือ!"
"[english]dota_chatwheel_label_kunkka_2"	"Heh! Man overboard!"
"dota_chatwheel_message_kunkka_3"	"พวกเจ้าล้วนตกกระป๋อง!"
"[english]dota_chatwheel_message_kunkka_3"	"You're all washed up!"
"dota_chatwheel_label_kunkka_3"	"พวกเจ้าล้วนตกกระป๋อง!"
"[english]dota_chatwheel_label_kunkka_3"	"You're all washed up!"
"dota_chatwheel_message_kunkka_4"	"เข้าใจตรงกันนะว่าที่ข้าเรียกเจ้าว่าสหาย ข้าไม่ได้หมายถึงว่าเจ้าเป็นสหายข้าจริง ๆ"
"[english]dota_chatwheel_message_kunkka_4"	"Just to be clear, if I call you mate, I don't mean it literally."
"dota_chatwheel_label_kunkka_4"	"เข้าใจตรงกันนะ..."
"[english]dota_chatwheel_label_kunkka_4"	"Just to be clear..."
"dota_chatwheel_message_kunkka_5"	"เจ้ารนหาที่ตายเองนะ"
"[english]dota_chatwheel_message_kunkka_5"	"You set sail for fail."
"dota_chatwheel_label_kunkka_5"	"เจ้ารนหาที่ตายเองนะ"
"[english]dota_chatwheel_label_kunkka_5"	"You set sail for fail."
"dota_chatwheel_message_lina_laugh"	"ฮ่า ฮ่า ฮ่า ฮ่า ฮ่า ฮ่า ฮ่า!"
"[english]dota_chatwheel_message_lina_laugh"	"Ha ha ha ha ha ha ha!"
"dota_chatwheel_label_lina_laugh"	"หัวเราะ"
"[english]dota_chatwheel_label_lina_laugh"	"Laugh"
"dota_chatwheel_message_lina_thank"	"นั่นแหละคือความเร่าร้อน!"
"[english]dota_chatwheel_message_lina_thank"	"That was hot!"
"dota_chatwheel_label_lina_thank"	"นั่นแหละคือความเร่าร้อน!"
"[english]dota_chatwheel_label_lina_thank"	"That was hot!"
"dota_chatwheel_message_lina_deny"	"แสบ ๆ ร้อน ๆ สินะ?"
"[english]dota_chatwheel_message_lina_deny"	"Burns, doesn't it?"
"dota_chatwheel_label_lina_deny"	"แสบ ๆ ร้อน ๆ สินะ?"
"[english]dota_chatwheel_label_lina_deny"	"Burns, doesn't it?"
"dota_chatwheel_message_lina_1"	"ก็ไม่ค่อยสว่างสักเท่าไรเนาะ"
"[english]dota_chatwheel_message_lina_1"	"That wasn't too bright."
"dota_chatwheel_label_lina_1"	"ก็ไม่ค่อยสว่างสักเท่าไรเนาะ"
"[english]dota_chatwheel_label_lina_1"	"That wasn't too bright."
"dota_chatwheel_message_lina_2"	"อยากจะเล่นกับไฟเรอะ?"
"[english]dota_chatwheel_message_lina_2"	"Wanna play with fire?"
"dota_chatwheel_label_lina_2"	"อยากจะเล่นกับไฟเรอะ?"
"[english]dota_chatwheel_label_lina_2"	"Wanna play with fire?"
"dota_chatwheel_message_lina_3"	"กากจริง ๆ"
"[english]dota_chatwheel_message_lina_3"	"What a punk."
"dota_chatwheel_label_lina_3"	"กากจริง ๆ"
"[english]dota_chatwheel_label_lina_3"	"What a punk."
"dota_chatwheel_message_lina_4"	"มีสิ่งใดอยู่ภายในเปลวเพลิงกันนะ?"
"[english]dota_chatwheel_message_lina_4"	"What in the blazes?"
"dota_chatwheel_label_lina_4"	"มีสิ่งใดอยู่ภายในเปลวเพลิงกันนะ?"
"[english]dota_chatwheel_label_lina_4"	"What in the blazes?"
"dota_chatwheel_message_lina_5"	"มาหาแม่มา!"
"[english]dota_chatwheel_message_lina_5"	"Come to mama!"
"dota_chatwheel_label_lina_5"	"มาหาแม่มา!"
"[english]dota_chatwheel_label_lina_5"	"Come to mama!"
"dota_chatwheel_message_lion_laugh"	"ฮั้ว-ฮ่า-ฮ่า-ฮ่า-ฮ่า-ฮ่า-ฮ่า-ฮี่-ฮ่าาฮ่า!"
"[english]dota_chatwheel_message_lion_laugh"	"Who-ha-ha-ha-ha-ha-ha-he-hawha!"
"dota_chatwheel_label_lion_laugh"	"หัวเราะ"
"[english]dota_chatwheel_label_lion_laugh"	"Laugh"
"dota_chatwheel_message_lion_thank"	"โอ้ แหล่มเลย"
"[english]dota_chatwheel_message_lion_thank"	"Oh, hell yes."
"dota_chatwheel_label_lion_thank"	"โอ้ แหล่มเลย"
"[english]dota_chatwheel_label_lion_thank"	"Oh, hell yes."
"dota_chatwheel_message_lion_deny"	"อ้า ขออภัยที่ทำให้เจ้าต้องผิดหวังนะ"
"[english]dota_chatwheel_message_lion_deny"	"Ah, sorry to disappoint you."
"dota_chatwheel_label_lion_deny"	"อ้า ขออภัยที่ทำให้เจ้าต้องผิดหวังนะ"
"[english]dota_chatwheel_label_lion_deny"	"Ah, sorry to disappoint you."
"dota_chatwheel_message_lion_1"	"เจ้าคิดว่าจะทำให้ Lion ผู้นี้สิ้นฤทธิ์ได้งั้นรึ?"
"[english]dota_chatwheel_message_lion_1"	"You thought to tame the lion?"
"dota_chatwheel_label_lion_1"	"เจ้าคิดว่าจะทำให้ Lion ผู้นี้สิ้นฤทธิ์ได้งั้นรึ?"
"[english]dota_chatwheel_label_lion_1"	"You thought to tame the lion?"
"dota_chatwheel_message_lion_2"	"จงรู้ซึ้งถึงความโกรธเกรี้ยวของนักเวทซะ!"
"[english]dota_chatwheel_message_lion_2"	"Feel the rage of a mage!"
"dota_chatwheel_label_lion_2"	"จงรู้ซึ้งถึงความโกรธเกรี้ยวของนักเวทซะ!"
"[english]dota_chatwheel_label_lion_2"	"Feel the rage of a mage!"
"dota_chatwheel_message_lion_3"	"ไปลงนรกเสียเถิด!"
"[english]dota_chatwheel_message_lion_3"	"To hell with you!"
"dota_chatwheel_label_lion_3"	"ไปลงนรกเสียเถิด!"
"[english]dota_chatwheel_label_lion_3"	"To hell with you!"
"dota_chatwheel_message_lion_4"	"ข้าถือครองพลังวิเศษเชียวนะ"
"[english]dota_chatwheel_message_lion_4"	"I've got the magic touch."
"dota_chatwheel_label_lion_4"	"ข้าถือครองพลังวิเศษเชียวนะ"
"[english]dota_chatwheel_label_lion_4"	"I've got the magic touch."
"dota_chatwheel_message_lion_5"	"ข้าเคยไปเยือนนรกและกลับมา และกลับไปเยือนนรก...และกลับมา"
"[english]dota_chatwheel_message_lion_5"	"I've been to hell and back, and back to hell...and back."
"dota_chatwheel_label_lion_5"	"ข้าเคยไปเยือนนรกและกลับมา..."
"[english]dota_chatwheel_label_lion_5"	"I've been to hell and back..."
"dota_chatwheel_message_shadow_shaman_laugh"	"ฮ่า ฮ่า ฮ่า!"
"[english]dota_chatwheel_message_shadow_shaman_laugh"	"Ha ha ha!"
"dota_chatwheel_label_shadow_shaman_laugh"	"หัวเราะ"
"[english]dota_chatwheel_label_shadow_shaman_laugh"	"Laugh"
"dota_chatwheel_message_shadow_shaman_thank"	"คำอธิษฐานของข้าสัมฤทธิ์ผลแล้ว"
"[english]dota_chatwheel_message_shadow_shaman_thank"	"My prayers are answered."
"dota_chatwheel_label_shadow_shaman_thank"	"คำอธิษฐานของข้าสัมฤทธิ์ผลแล้ว"
"[english]dota_chatwheel_label_shadow_shaman_thank"	"My prayers are answered."
"dota_chatwheel_message_shadow_shaman_deny"	"กะต๊าก กะต๊าก!"
"[english]dota_chatwheel_message_shadow_shaman_deny"	"Bukaw, bukaw!"
"dota_chatwheel_label_shadow_shaman_deny"	"กะต๊าก กะต๊าก!"
"[english]dota_chatwheel_label_shadow_shaman_deny"	"Bukaw, bukaw!"
"dota_chatwheel_message_shadow_shaman_1"	"ข้าเห็นอนาคตของเจ้าซึ่งเต็มไปด้วยความตาย!"
"[english]dota_chatwheel_message_shadow_shaman_1"	"I see for you a future full of death!"
"dota_chatwheel_label_shadow_shaman_1"	"ข้าเห็นอนาคตของเจ้า..."
"[english]dota_chatwheel_label_shadow_shaman_1"	"I see for you a future..."
"dota_chatwheel_message_shadow_shaman_2"	"เจ้าจะไปไหนไม่ได้ทั้งนั้น"
"[english]dota_chatwheel_message_shadow_shaman_2"	"You're not going anywhere."
"dota_chatwheel_label_shadow_shaman_2"	"เจ้าจะไปไหนไม่ได้ทั้งนั้น"
"[english]dota_chatwheel_label_shadow_shaman_2"	"You're not going anywhere."
"dota_chatwheel_message_shadow_shaman_3"	"ฮ้า ฮะฮ่ะฮ่าา ช่างสดชื่นอะไรเยี่ยงนี้!"
"[english]dota_chatwheel_message_shadow_shaman_3"	"Heh ha ha hah, how refreshing!"
"dota_chatwheel_label_shadow_shaman_3"	"ฮ้า ฮะฮ่ะฮ่าา ช่างสดชื่นอะไรเยี่ยงนี้!"
"[english]dota_chatwheel_label_shadow_shaman_3"	"Heh ha ha hah, how refreshing!"
"dota_chatwheel_message_shadow_shaman_4"	"จงลิ้มรสกับการเป็นไก่ซะเถอะ!"
"[english]dota_chatwheel_message_shadow_shaman_4"	"Tastes like chicken!"
"dota_chatwheel_label_shadow_shaman_4"	"จงลิ้มรสกับการเป็นไก่ซะเถอะ!"
"[english]dota_chatwheel_label_shadow_shaman_4"	"Tastes like chicken!"
"dota_chatwheel_message_shadow_shaman_5"	"อาห์-โมะซู-อติ๊กคานู!"
"[english]dota_chatwheel_message_shadow_shaman_5"	"Au-mosu-atikanu!"
"dota_chatwheel_label_shadow_shaman_5"	"อาห์-โมะซู-อติ๊กคานู!"
"[english]dota_chatwheel_label_shadow_shaman_5"	"Au-mosu-atikanu!"
"dota_chatwheel_message_slardar_laugh"	"ฮื้อ ฮื่ออ ฮื้อ ฮ่าา ฮ่าา ฮ่า ฮ่าา ฮ่าา!"
"[english]dota_chatwheel_message_slardar_laugh"	"Heh heeh heh hah hah ha hah hah!"
"dota_chatwheel_label_slardar_laugh"	"หัวเราะ"
"[english]dota_chatwheel_label_slardar_laugh"	"Laugh"
"dota_chatwheel_message_slardar_thank"	"อุดมสมบูรณ์จริง ๆ"
"[english]dota_chatwheel_message_slardar_thank"	"Total spawnage."
"dota_chatwheel_label_slardar_thank"	"อุดมสมบูรณ์จริง ๆ"
"[english]dota_chatwheel_label_slardar_thank"	"Total spawnage."
"dota_chatwheel_message_slardar_deny"	"ขอแสดงความเสียใจอย่างสุดลึกซึ้ง"
"[english]dota_chatwheel_message_slardar_deny"	"My deepest sympathies."
"dota_chatwheel_label_slardar_deny"	"ขอแสดงความเสียใจอย่างสุดลึกซึ้ง"
"[english]dota_chatwheel_label_slardar_deny"	"My deepest sympathies."
"dota_chatwheel_message_slardar_1"	"ข้าเดินทางมาแสนไกล เพียงเพื่อมาดูเจ้าตาย"
"[english]dota_chatwheel_message_slardar_1"	"I came a long way to see you die."
"dota_chatwheel_label_slardar_1"	"ข้าเดินทางมาแสนไกล..."
"[english]dota_chatwheel_label_slardar_1"	"I came a long way..."
"dota_chatwheel_message_slardar_2"	"เจ้ามิอาจหลบหนีไปไหนได้"
"[english]dota_chatwheel_message_slardar_2"	"You won't escape."
"dota_chatwheel_label_slardar_2"	"เจ้ามิอาจหลบหนีไปไหนได้"
"[english]dota_chatwheel_label_slardar_2"	"You won't escape."
"dota_chatwheel_message_slardar_3"	"จบเกม"
"[english]dota_chatwheel_message_slardar_3"	"Jig's up."
"dota_chatwheel_label_slardar_3"	"จบเกม"
"[english]dota_chatwheel_label_slardar_3"	"Jig's up."
"dota_chatwheel_message_slardar_4"	"ความคิดเจ้าตื้นเขินจริง ๆ"
"[english]dota_chatwheel_message_slardar_4"	"You were out of your depth."
"dota_chatwheel_label_slardar_4"	"ความคิดเจ้าตื้นเขินจริง ๆ"
"[english]dota_chatwheel_label_slardar_4"	"You were out of your depth."
"dota_chatwheel_message_slardar_5"	"โอ้ เหล่าชาว Deep One จะได้เฉลิมฉลองกันอย่างสาสม!"
"[english]dota_chatwheel_message_slardar_5"	"Oh, how the deep ones will feast!"
"dota_chatwheel_label_slardar_5"	"โอ้ เหล่าชาว Deep One จะได้เฉลิมฉลองกันอย่างสาสม!"
"[english]dota_chatwheel_label_slardar_5"	"Oh, how the deep ones will feast!"
"dota_chatwheel_message_tidehunter_laugh"	"ฮ้า ฮ่า ฮ่า ฮ่า!"
"[english]dota_chatwheel_message_tidehunter_laugh"	"Ah ha ha ha!"
"dota_chatwheel_label_tidehunter_laugh"	"หัวเราะ"
"[english]dota_chatwheel_label_tidehunter_laugh"	"Laugh"
"dota_chatwheel_message_tidehunter_thank"	"พวกเรามาพลิกวิกฤตนี้ให้เป็นโอกาสกันเหอะ"
"[english]dota_chatwheel_message_tidehunter_thank"	"We'll turn this tide to our advantage."
"dota_chatwheel_label_tidehunter_thank"	"พวกเรามาพลิกวิกฤตนี้ให้เป็นโอกาสกันเหอะ"
"[english]dota_chatwheel_label_tidehunter_thank"	"We'll turn this tide to our advantage."
"dota_chatwheel_message_tidehunter_deny"	"แกดูเสียหายยับเยินนะ"
"[english]dota_chatwheel_message_tidehunter_deny"	"You look ravaged."
"dota_chatwheel_label_tidehunter_deny"	"แกดูเสียหายยับเยินนะ"
"[english]dota_chatwheel_label_tidehunter_deny"	"You look ravaged."
"dota_chatwheel_message_tidehunter_1"	"ฮ่า ฮ่า ฮ่า ฮ่า ฮ่า ฮ่า แกกลายเป็นอาหารปลาซะแล้วล่ะ"
"[english]dota_chatwheel_message_tidehunter_1"	"Ha ha ha ha ha ha, Now you're fish food."
"dota_chatwheel_label_tidehunter_1"	"แกกลายเป็นอาหารปลาซะแล้วล่ะ"
"[english]dota_chatwheel_label_tidehunter_1"	"Now you're fish food."
"dota_chatwheel_message_tidehunter_2"	"ฮ่า ฮ่า ข้าน่าจะเขมือบช้างทะเลได้ทั้งตัวแล้ว"
"[english]dota_chatwheel_message_tidehunter_2"	"Ha ha I could eat a walrus."
"dota_chatwheel_label_tidehunter_2"	"ฮ่า ฮ่า ข้าน่าจะเขมือบช้างทะเลได้ทั้งตัวแล้ว"
"[english]dota_chatwheel_label_tidehunter_2"	"Ha ha I could eat a walrus."
"dota_chatwheel_message_tidehunter_3"	"หาอะไรมาปิดปากมันหน่อยสิ"
"[english]dota_chatwheel_message_tidehunter_3"	"Put a cork in it."
"dota_chatwheel_label_tidehunter_3"	"หาอะไรมาปิดปากมันหน่อยสิ"
"[english]dota_chatwheel_label_tidehunter_3"	"Put a cork in it."
"dota_chatwheel_message_tidehunter_4"	"แกคิดว่าข้าซื่อบื้องั้นเหรอ? แกคงเข้าใจผิดคิดว่าข้าเป็น Kunkka แล้วแหละ"
"[english]dota_chatwheel_message_tidehunter_4"	"Did you think I'd blunder? You must have mistaken me for Kunkka."
"dota_chatwheel_label_tidehunter_4"	"แกคิดว่าข้าซื่อบื้องั้นเหรอ?..."
"[english]dota_chatwheel_label_tidehunter_4"	"Did you think I'd blunder?..."
"dota_chatwheel_message_tidehunter_5"	"ใครอยากจะมีหัวที่ดี เมื่อแกมีฟันอย่างข้าแล้ว?"
"[english]dota_chatwheel_message_tidehunter_5"	"Who needs a big brain when you've got teeth like mine?"
"dota_chatwheel_label_tidehunter_5"	"ใครอยากจะมีหัวที่ดี...?"
"[english]dota_chatwheel_label_tidehunter_5"	"Who needs a big brain...?"
"dota_chatwheel_message_witch_doctor_laugh"	"โฮ้ว ฮ่าา โฮ้ว โฮ้ว ฮ่าา"
"[english]dota_chatwheel_message_witch_doctor_laugh"	"Hoo hah hoo hoo hah."
"dota_chatwheel_label_witch_doctor_laugh"	"หัวเราะ"
"[english]dota_chatwheel_label_witch_doctor_laugh"	"Laugh"
"dota_chatwheel_message_witch_doctor_thank"	"รู้สึกดีจังเลยจ๊ะนายจ๋า"
"[english]dota_chatwheel_message_witch_doctor_thank"	"Feeling good, man."
"dota_chatwheel_label_witch_doctor_thank"	"รู้สึกดีจังเลยจ๊ะนายจ๋า"
"[english]dota_chatwheel_label_witch_doctor_thank"	"Feeling good, man."
"dota_chatwheel_message_witch_doctor_deny"	"รออีกเดี๋ยว...รออีกเดี๋ยว..."
"[english]dota_chatwheel_message_witch_doctor_deny"	"Wait for it...wait for it..."
"dota_chatwheel_label_witch_doctor_deny"	"รออีกเดี๋ยว...รออีกเดี๋ยว..."
"[english]dota_chatwheel_label_witch_doctor_deny"	"Wait for it...wait for it..."
"dota_chatwheel_message_witch_doctor_1"	"เละตุ้มเป๊ะไปโม้ด"
"[english]dota_chatwheel_message_witch_doctor_1"	"Dat make a big mess."
"dota_chatwheel_label_witch_doctor_1"	"เละตุ้มเป๊ะไปโม้ด"
"[english]dota_chatwheel_label_witch_doctor_1"	"Dat make a big mess."
"dota_chatwheel_message_witch_doctor_2"	"ไหนใครเรียกหาหมอ?"
"[english]dota_chatwheel_message_witch_doctor_2"	"Someone call de doctor?"
"dota_chatwheel_label_witch_doctor_2"	"ไหนใครเรียกหาหมอ?"
"[english]dota_chatwheel_label_witch_doctor_2"	"Someone call de doctor?"
"dota_chatwheel_message_witch_doctor_3"	"โอ้ มองตามที่มันพุ่งไปสิ"
"[english]dota_chatwheel_message_witch_doctor_3"	"Oh, look at it go."
"dota_chatwheel_label_witch_doctor_3"	"โอ้ มองตามที่มันพุ่งไปสิ"
"[english]dota_chatwheel_label_witch_doctor_3"	"Oh, look at it go."
"dota_chatwheel_message_witch_doctor_4"	"เตรียมเสียบกระดูกย่างได้เลย เจ้าเสร็จข้าละ"
"[english]dota_chatwheel_message_witch_doctor_4"	"Stick a bone in it. You're done."
"dota_chatwheel_label_witch_doctor_4"	"เตรียมเสียบกระดูกย่างได้เลย เจ้าเสร็จข้าละ"
"[english]dota_chatwheel_label_witch_doctor_4"	"Stick a bone in it. You're done."
"dota_chatwheel_message_witch_doctor_5"	"โอ๊ ยาาาาาห์"
"[english]dota_chatwheel_message_witch_doctor_5"	"Oyeaaaaah."
"dota_chatwheel_label_witch_doctor_5"	"โอ๊ ยาาาาาห์"
"[english]dota_chatwheel_label_witch_doctor_5"	"Oyeaaaaah."
"dota_chatwheel_message_lich_laugh"	"ฮ่า ฮ่า ฮ่า ฮ่า ฮ่า ฮ่า ฮ่า ฮ่า!"
"[english]dota_chatwheel_message_lich_laugh"	"Ha ha ha ha ha ha ha ha!"
"dota_chatwheel_label_lich_laugh"	"หัวเราะ"
"[english]dota_chatwheel_label_lich_laugh"	"Laugh"
"dota_chatwheel_message_lich_thank"	"จงเย็นไว้!"
"[english]dota_chatwheel_message_lich_thank"	"Stay frosty!"
"dota_chatwheel_label_lich_thank"	"จงเย็นไว้!"
"[english]dota_chatwheel_label_lich_thank"	"Stay frosty!"
"dota_chatwheel_message_lich_deny"	"ก้าวระวัง ๆ ล้มแล้วร่วงลึกนะ"
"[english]dota_chatwheel_message_lich_deny"	"Watch your step, it's six feet down."
"dota_chatwheel_label_lich_deny"	"ก้าวระวัง ๆ..."
"[english]dota_chatwheel_label_lich_deny"	"Watch your step..."
"dota_chatwheel_message_lich_1"	"เจ้ามิอาจฆ่าคนตายได้หรอก"
"[english]dota_chatwheel_message_lich_1"	"Can't kill the dead."
"dota_chatwheel_label_lich_1"	"เจ้ามิอาจฆ่าคนตายได้หรอก"
"[english]dota_chatwheel_label_lich_1"	"Can't kill the dead."
"dota_chatwheel_message_lich_2"	"เสียวซ่าไหมจ๊ะ?"
"[english]dota_chatwheel_message_lich_2"	"Does it tingle?"
"dota_chatwheel_label_lich_2"	"เสียวซ่าไหมจ๊ะ?"
"[english]dota_chatwheel_label_lich_2"	"Does it tingle?"
"dota_chatwheel_message_lich_3"	"สัมผัสโอบกอดแห่งความหนาวเหน็บของข้าซะ!"
"[english]dota_chatwheel_message_lich_3"	"Feel my cold embrace!"
"dota_chatwheel_label_lich_3"	"สัมผัสโอบกอดแห่งความหนาวเหน็บของข้าซะ!"
"[english]dota_chatwheel_label_lich_3"	"Feel my cold embrace!"
"dota_chatwheel_message_lich_5"	"อ้า Ice Frog!"
"[english]dota_chatwheel_message_lich_5"	"Ah, Ice Frog!"
"dota_chatwheel_label_lich_5"	"อ้า Ice Frog!"
"[english]dota_chatwheel_label_lich_5"	"Ah, Ice Frog!"
"dota_chatwheel_message_riki_laugh"	"โฮ้ว โฮ้ว โฮ้ว โฮ้ว โฮ้ว โฮ้ว โฮ้ว"
"[english]dota_chatwheel_message_riki_laugh"	"hoo hoo hoo hoo hoo hoo hoo."
"dota_chatwheel_label_riki_laugh"	"หัวเราะ"
"[english]dota_chatwheel_label_riki_laugh"	"Laugh"
"dota_chatwheel_message_riki_thank"	"ภารกิจเสร็จสมบูรณ์"
"[english]dota_chatwheel_message_riki_thank"	"Contract complete."
"dota_chatwheel_label_riki_thank"	"ภารกิจเสร็จสมบูรณ์"
"[english]dota_chatwheel_label_riki_thank"	"Contract complete."
"dota_chatwheel_message_riki_deny"	"อะฮ่า เจ้าไม่เห็นล่ะสิว่าจะเกิดอะไรขึ้น"
"[english]dota_chatwheel_message_riki_deny"	"Heh-ho, you didn't see that coming."
"dota_chatwheel_label_riki_deny"	"เจ้าไม่เห็นล่ะสิว่าจะเกิดอะไรขึ้น"
"[english]dota_chatwheel_label_riki_deny"	"You didn't see that coming."
"dota_chatwheel_message_riki_1"	"จะยืดเยื้อให้เสียเวลาทำไม?"
"[english]dota_chatwheel_message_riki_1"	"Why prolong the inevitable?"
"dota_chatwheel_label_riki_1"	"จะยืดเยื้อให้เสียเวลาทำไม?"
"[english]dota_chatwheel_label_riki_1"	"Why prolong the inevitable?"
"dota_chatwheel_message_riki_2"	"จ๊ะเอ๋"
"[english]dota_chatwheel_message_riki_2"	"Peek-a-boo."
"dota_chatwheel_label_riki_2"	"จ๊ะเอ๋"
"[english]dota_chatwheel_label_riki_2"	"Peek-aboo."
"dota_chatwheel_message_riki_3"	"ถ้าเจ้าเห็นข้า แปลว่าเจ้าตายแล้ว"
"[english]dota_chatwheel_message_riki_3"	"If you can see me, you're already dead."
"dota_chatwheel_label_riki_3"	"ถ้าเจ้าเห็นข้า..."
"[english]dota_chatwheel_label_riki_3"	"If you can see me..."
"dota_chatwheel_message_riki_4"	"ข้าอยู่ที่นี่มาตั้งนานแล้ว"
"[english]dota_chatwheel_message_riki_4"	"I've been here the whole time."
"dota_chatwheel_label_riki_4"	"ข้าอยู่ที่นี่มาตั้งนานแล้ว"
"[english]dota_chatwheel_label_riki_4"	"I've been here the whole time."
"dota_chatwheel_message_riki_5"	"อะอ้าว เจ้าตายแล้ว น่าแปลกใจจัง"
"[english]dota_chatwheel_message_riki_5"	"Oh you're dead. What a surprise."
"dota_chatwheel_label_riki_5"	"อะอ้าว เจ้าตายแล้ว น่าแปลกใจจัง"
"[english]dota_chatwheel_label_riki_5"	"Oh you're dead. What a surprise."
"dota_chatwheel_message_enigma_laugh"	"ฮี่-ฮี่-ฮื้อ-ฮื่อ-ฮื่อ"
"[english]dota_chatwheel_message_enigma_laugh"	"He-he-huh-heh-heh."
"dota_chatwheel_label_enigma_laugh"	"หัวเราะ"
"[english]dota_chatwheel_label_enigma_laugh"	"Laugh"
"dota_chatwheel_message_enigma_2"	"ความเงียบมีค่าประดุจทอง"
"[english]dota_chatwheel_message_enigma_2"	"Silence is golden."
"dota_chatwheel_label_enigma_2"	"ความเงียบมีค่าประดุจทอง"
"[english]dota_chatwheel_label_enigma_2"	"Silence is golden."
"dota_chatwheel_message_enigma_3"	"เจ้าอยู่ต่ำกว่าข้า"
"[english]dota_chatwheel_message_enigma_3"	"You are beneath me."
"dota_chatwheel_label_enigma_3"	"เจ้าอยู่ต่ำกว่าข้า"
"[english]dota_chatwheel_label_enigma_3"	"You are beneath me."
"dota_chatwheel_message_tinker_laugh"	"ฮ้า ฮ่า ฮ่า ฮ่า ฮ่า!"
"[english]dota_chatwheel_message_tinker_laugh"	"Ah ha ha ha ha!"
"dota_chatwheel_label_tinker_laugh"	"หัวเราะ"
"[english]dota_chatwheel_label_tinker_laugh"	"Laugh"
"dota_chatwheel_message_tinker_thank"	"พรสวรรค์ของเจ้านั้นเยอะกว่าความน่ารักเหลือหลาย"
"[english]dota_chatwheel_message_tinker_thank"	"Your talents surpass your loveliness."
"dota_chatwheel_label_tinker_thank"	"พรสวรรค์ของเจ้านั้นเยอะกว่าความน่ารักเหลือหลาย"
"[english]dota_chatwheel_label_tinker_thank"	"Your talents surpass your loveliness."
"dota_chatwheel_message_tinker_deny"	"อืม มันก็ดีไม่ใช่น้อยเลยนะ!"
"[english]dota_chatwheel_message_tinker_deny"	"Well isn't that something!"
"dota_chatwheel_label_tinker_deny"	"อืม มันก็ดีไม่ใช่น้อยเลยนะ!"
"[english]dota_chatwheel_label_tinker_deny"	"Well isn't that something!"
"dota_chatwheel_message_tinker_1"	"ปิ้ว ปิ้ว ปิ้ว-ปิ้ว-ปิ้ว!"
"[english]dota_chatwheel_message_tinker_1"	"Pew, pew, pew pew pew!"
"dota_chatwheel_label_tinker_1"	"ปิ้ว ปิ้ว ปิ้ว-ปิ้ว-ปิ้ว!"
"[english]dota_chatwheel_label_tinker_1"	"Pew, pew, pew pew pew!"
"dota_chatwheel_message_tinker_2"	"รู้มั้ยว่าข้าคาดการณ์ทุกอย่างไว้ล่วงหน้าหมดแล้ว ทุกอย่างเลย!"
"[english]dota_chatwheel_message_tinker_2"	"I predicted all of this you know, all of it!"
"dota_chatwheel_label_tinker_2"	"รู้มั้ยว่าข้าคาดการณ์ทุกอย่างไว้ล่วงหน้าหมดแล้ว..."
"[english]dota_chatwheel_label_tinker_2"	"I predicted all of this you know..."
"dota_chatwheel_message_tinker_3"	"อัจฉริยะมาก!"
"[english]dota_chatwheel_message_tinker_3"	"That was genius!"
"dota_chatwheel_label_tinker_3"	"อัจฉริยะมาก!"
"[english]dota_chatwheel_label_tinker_3"	"That was genius!"
"dota_chatwheel_message_sniper_laugh"	"ฮื่อ ฮื่อ ฮื่อ ฮื่อ ฮื่อ ฮื่อ ฮื่อ ฮื่อ ฮื่อ ฮื่อ!"
"[english]dota_chatwheel_message_sniper_laugh"	"Hee hee hee hee hee hee hee hee hee hee!"
"dota_chatwheel_label_sniper_laugh"	"หัวเราะ"
"[english]dota_chatwheel_label_sniper_laugh"	"Laugh"
"dota_chatwheel_message_sniper_thank"	"สมกับที่ซ้อมยิงมา!"
"[english]dota_chatwheel_message_sniper_thank"	"Target practice, payin' off!"
"dota_chatwheel_label_sniper_thank"	"สมกับที่ซ้อมยิงมา!"
"[english]dota_chatwheel_label_sniper_thank"	"Target practice, payin' off!"
"dota_chatwheel_message_sniper_deny"	"อะไรกัน---?"
"[english]dota_chatwheel_message_sniper_deny"	"What the---?"
"dota_chatwheel_label_sniper_deny"	"อะไรกัน---?"
"[english]dota_chatwheel_label_sniper_deny"	"What the---?"
"dota_chatwheel_message_sniper_1"	"บอกลาหัวของเอ็งไว้ซะนะ!"
"[english]dota_chatwheel_message_sniper_1"	"Say goodbye to your head!"
"dota_chatwheel_label_sniper_1"	"บอกลาหัวของเอ็งไว้ซะนะ!"
"[english]dota_chatwheel_label_sniper_1"	"Say goodbye to your head!"
"dota_chatwheel_message_sniper_2"	"เต้นสิวะ! ฮะฮะฮ่ะฮ่า! เต้น!"
"[english]dota_chatwheel_message_sniper_2"	"Dance! Ha ha ha ha! Dance!"
"dota_chatwheel_label_sniper_2"	"เต้นสิวะ! ฮะฮะฮ่ะฮ่า! เต้น!"
"[english]dota_chatwheel_label_sniper_2"	"Dance! Ha ha ha ha! Dance!"
"dota_chatwheel_message_sniper_3"	"ทำไมข้าถึงยิ้มนะเรอะ? ก็เพราะพร้อมจะเหนี่ยวไกแล้วไงล่ะ"
"[english]dota_chatwheel_message_sniper_3"	"Why am I smiling? This is what trigger-happy looks like."
"dota_chatwheel_label_sniper_3"	"ทำไมข้าถึงยิ้มนะเรอะ?..."
"[english]dota_chatwheel_label_sniper_3"	"Why am I smiling?..."
"dota_chatwheel_message_sniper_4"	"โง่งั่งจริง ๆ!"
"[english]dota_chatwheel_message_sniper_4"	"What a dum-dum!"
"dota_chatwheel_label_sniper_4"	"โง่งั่งจริง ๆ"
"[english]dota_chatwheel_label_sniper_4"	"What a dumb dumb"
"dota_chatwheel_message_sniper_5"	"โฮ้ โฮ ฮ่า ฮ่า!"
"[english]dota_chatwheel_message_sniper_5"	"Ho ho ha ha!"
"dota_chatwheel_label_sniper_5"	"โฮ้ โฮ ฮ่า ฮ่า!"
"[english]dota_chatwheel_label_sniper_5"	"Ho ho ha ha!"
"dota_chatwheel_message_necrolyte_laugh"	"ฮ่า ฮ่า ฮ่า ฮ่า ฮ่า ฮ่า ฮ่า ฮ่า ฮ่า ฮ่า ฮ่า ฮ่า!"
"[english]dota_chatwheel_message_necrolyte_laugh"	"Ha ha ha ha ha ha ha ha ha ha ha ha!"
"dota_chatwheel_label_necrolyte_laugh"	"หัวเราะ"
"[english]dota_chatwheel_label_necrolyte_laugh"	"Laugh"
"dota_chatwheel_message_necrolyte_thank"	"สูดเข้าไป"
"[english]dota_chatwheel_message_necrolyte_thank"	"Breathe it in."
"dota_chatwheel_label_necrolyte_thank"	"สูดเข้าไป"
"[english]dota_chatwheel_label_necrolyte_thank"	"Breathe it in."
"dota_chatwheel_message_necrolyte_deny"	"แพงมากเลยนะ"
"[english]dota_chatwheel_message_necrolyte_deny"	"That was costly."
"dota_chatwheel_label_necrolyte_deny"	"แพงมากเลยนะ"
"[english]dota_chatwheel_label_necrolyte_deny"	"That was costly."
"dota_chatwheel_message_necrolyte_3"	"เน่าเฟะไปหมดแล้ว"
"[english]dota_chatwheel_message_necrolyte_3"	"It's all gone rotten."
"dota_chatwheel_label_necrolyte_3"	"เน่าเฟะไปหมดแล้ว"
"[english]dota_chatwheel_label_necrolyte_3"	"It's all gone rotten."
"dota_chatwheel_message_warlock_laugh"	"โฮ้ ฮ่า ฮ่า ฮ่า ฮ่า ฮ่า ฮ่า ฮ่า ฮ่า!"
"[english]dota_chatwheel_message_warlock_laugh"	"Ho ha ha ha ha ha ha ha ha!"
"dota_chatwheel_label_warlock_laugh"	"หัวเราะ"
"[english]dota_chatwheel_label_warlock_laugh"	"Laugh"
"dota_chatwheel_message_warlock_thank"	"เริ่มยุคแห่งความโกลาหล!"
"[english]dota_chatwheel_message_warlock_thank"	"Let chaos reign!"
"dota_chatwheel_label_warlock_thank"	"เริ่มยุคแห่งความโกลาหล!"
"[english]dota_chatwheel_label_warlock_thank"	"Let chaos reign!"
"dota_chatwheel_message_warlock_4"	"พวกกระจอก"
"[english]dota_chatwheel_message_warlock_4"	"Pipsqueak."
"dota_chatwheel_label_warlock_4"	"พวกกระจอก"
"[english]dota_chatwheel_label_warlock_4"	"Pipsqueak."
"dota_chatwheel_message_beastmaster_laugh"	"โฮ่วฮื้อ ฮื่อ ฮื่อ ฮื้อ ฮ่าา ฮื่อ ฮื่อ ฮื่อ"
"[english]dota_chatwheel_message_beastmaster_laugh"	"Howeh heh heh eh hah heh heh heh."
"dota_chatwheel_label_beastmaster_laugh"	"หัวเราะ"
"[english]dota_chatwheel_label_beastmaster_laugh"	"Laugh"
"dota_chatwheel_message_beastmaster_thank"	"ล่าพวกมัน!"
"[english]dota_chatwheel_message_beastmaster_thank"	"Sic 'em!"
"dota_chatwheel_label_beastmaster_thank"	"ล่าพวกมัน!"
"[english]dota_chatwheel_label_beastmaster_thank"	"Sic 'em!"
"dota_chatwheel_message_beastmaster_1"	"ไปตายให้หนอนกินเถอะ"
"[english]dota_chatwheel_message_beastmaster_1"	"The worms will have you."
"dota_chatwheel_label_beastmaster_1"	"ไปตายให้หนอนกินเถอะ"
"[english]dota_chatwheel_label_beastmaster_1"	"The worms will have you."
"dota_chatwheel_message_beastmaster_4"	"อืม ข้าน่าจะเรียนรู้วิธีอ่านนะ"
"[english]dota_chatwheel_message_beastmaster_4"	"Hmm, wish I'd learned how to read."
"dota_chatwheel_label_beastmaster_4"	"อืม ข้าน่าจะเรียนรู้วิธีอ่านนะ"
"[english]dota_chatwheel_label_beastmaster_4"	"Hmm, wish I'd learned how to read."
"dota_chatwheel_message_beastmaster_5"	"ฮู่ ฮู่ ฮู่"
"[english]dota_chatwheel_message_beastmaster_5"	"Hoo hoo hoo."
"dota_chatwheel_label_beastmaster_5"	"ฮู่ ฮู่ ฮู่"
"[english]dota_chatwheel_label_beastmaster_5"	"Hoo hoo hoo."
"dota_chatwheel_message_queenofpain_laugh"	"ฮ้า ฮ่า ฮ่า ฮ่า ฮ่า ฮ่า ฮ่า ฮ่า ฮ่า ฮ่า ฮ่า ฮ่า!"
"[english]dota_chatwheel_message_queenofpain_laugh"	"Uh ha ha ha ha ha ha ha ha ha ha ha!"
"dota_chatwheel_label_queenofpain_laugh"	"หัวเราะ"
"[english]dota_chatwheel_label_queenofpain_laugh"	"Laugh"
"dota_chatwheel_message_queenofpain_thank"	"จะต้องมีเสียงร้อง จะต้องมีเสียงทรมาน"
"[english]dota_chatwheel_message_queenofpain_thank"	"There will be pain, there will be screaming."
"dota_chatwheel_label_queenofpain_thank"	"จะต้องมีเสียงร้อง..."
"[english]dota_chatwheel_label_queenofpain_thank"	"There will be pain..."
"dota_chatwheel_message_queenofpain_deny"	"เรามักทำร้ายคนที่เรารัก"
"[english]dota_chatwheel_message_queenofpain_deny"	"You hurt the ones you love."
"dota_chatwheel_label_queenofpain_deny"	"เรามักทำร้ายคนที่เรารัก"
"[english]dota_chatwheel_label_queenofpain_deny"	"You hurt the ones you love."
"dota_chatwheel_message_queenofpain_1"	"สมบูรณ์แบบที่สุด"
"[english]dota_chatwheel_message_queenofpain_1"	"That was perfect."
"dota_chatwheel_label_queenofpain_1"	"สมบูรณ์แบบที่สุด"
"[english]dota_chatwheel_label_queenofpain_1"	"That was perfect."
"dota_chatwheel_message_queenofpain_2"	"แบบนี้เจ็บไหม?"
"[english]dota_chatwheel_message_queenofpain_2"	"Does this hurt?"
"dota_chatwheel_label_queenofpain_2"	"แบบนี้เจ็บไหม?"
"[english]dota_chatwheel_label_queenofpain_2"	"Does this hurt?"
"dota_chatwheel_message_queenofpain_3"	"ชอบจริง ๆ ตอนที่เจ้าทนทุราย"
"[english]dota_chatwheel_message_queenofpain_3"	"I love it when you resist."
"dota_chatwheel_label_queenofpain_3"	"ชอบจริง ๆ ตอนที่เจ้าทนทุราย"
"[english]dota_chatwheel_label_queenofpain_3"	"I love it when you resist."
"dota_chatwheel_message_queenofpain_4"	"เจ้าอยากจับข้ารึ? ตามมาให้ทันสิ"
"[english]dota_chatwheel_message_queenofpain_4"	"You want me? Come get me."
"dota_chatwheel_label_queenofpain_4"	"เจ้าอยากจับข้ารึ? ตามมาให้ทันสิ"
"[english]dota_chatwheel_label_queenofpain_4"	"You want me? Come get me."
"dota_chatwheel_message_queenofpain_5"	"ข้ารู้ ข้าคือความเจ็บปวด แต่เจ้าก็รักข้าอยู่ดีใช่มั้ยล่ะ"
"[english]dota_chatwheel_message_queenofpain_5"	"I know I'm a pain, but you love me anyway."
"dota_chatwheel_label_queenofpain_5"	"ข้ารู้ ข้าคือความเจ็บปวด..."
"[english]dota_chatwheel_label_queenofpain_5"	"I know I'm a pain..."
"dota_chatwheel_message_venomancer_laugh"	"สสสะ ฮี้ ฮี่ ฮี่ ฮี่ ฮี่"
"[english]dota_chatwheel_message_venomancer_laugh"	"Sss eh he he he he."
"dota_chatwheel_label_venomancer_laugh"	"หัวเราะ"
"[english]dota_chatwheel_label_venomancer_laugh"	"Laugh"
"dota_chatwheel_message_venomancer_thank"	"มาระบาดพิษให้ศัตรูเรากัน!"
"[english]dota_chatwheel_message_venomancer_thank"	"Plague our enemies!"
"dota_chatwheel_label_venomancer_thank"	"มาระบาดพิษให้ศัตรูเรากัน!"
"[english]dota_chatwheel_label_venomancer_thank"	"Plague our enemies!"
"dota_chatwheel_message_venomancer_deny"	"อู้ว ทำไมแพง"
"[english]dota_chatwheel_message_venomancer_deny"	"Oh, costly."
"dota_chatwheel_label_venomancer_deny"	"อู้ว ทำไมแพง"
"[english]dota_chatwheel_label_venomancer_deny"	"Oh, costly."
"dota_chatwheel_message_venomancer_1"	"ไม่มีสิ่งใดกินใจไปมากกว่าพิษของข้า"
"[english]dota_chatwheel_message_venomancer_1"	"Nothing touches the heart like my venom."
"dota_chatwheel_label_venomancer_1"	"ไม่มีสิ่งใดกินใจ..."
"[english]dota_chatwheel_label_venomancer_1"	"Nothing touches the heart..."
"dota_chatwheel_message_venomancer_2"	"ซือออ แสบหน่อยนะ"
"[english]dota_chatwheel_message_venomancer_2"	"Ssss, that burns."
"dota_chatwheel_label_venomancer_2"	"ซือออ แสบหน่อยนะ"
"[english]dota_chatwheel_label_venomancer_2"	"Ssss, that burns."
"dota_chatwheel_message_venomancer_3"	"เจ้าหนีไม่พ้นพิษอย่างข้าหรอก..."
"[english]dota_chatwheel_message_venomancer_3"	"You can't run from the venomous one!"
"dota_chatwheel_label_venomancer_3"	"เจ้าหนีไม่พ้นหรอก..."
"[english]dota_chatwheel_label_venomancer_3"	"You can't run..."
"dota_chatwheel_message_venomancer_4"	"ทั้งหมดนี้เป็นเพราะข้าเองแหละ"
"[english]dota_chatwheel_message_venomancer_4"	"I owe it all to me."
"dota_chatwheel_label_venomancer_4"	"ทั้งหมดนี้เป็นเพราะข้าเองแหละ"
"[english]dota_chatwheel_label_venomancer_4"	"I owe it all to me."
"dota_chatwheel_message_venomancer_5"	"อ้าห์ พิษแสนหวาน!"
"[english]dota_chatwheel_message_venomancer_5"	"Ah, sweet toxicity!"
"dota_chatwheel_label_venomancer_5"	"อ้าห์ พิษแสนหวาน!"
"[english]dota_chatwheel_label_venomancer_5"	"Ah, sweet toxicity!"
"dota_chatwheel_message_faceless_void_laugh"	"ฮื่อ ฮื่อ ฮ่าา ฮ่า ฮ่าา ฮื่อ เฮ้ ฮื่อ"
"[english]dota_chatwheel_message_faceless_void_laugh"	"Heh heh hah ha hah heh heah heh."
"dota_chatwheel_label_faceless_void_laugh"	"หัวเราะ"
"[english]dota_chatwheel_label_faceless_void_laugh"	"Laugh"
"dota_chatwheel_message_faceless_void_deny"	"บางสิ่งไม่ควรเป็นแบบนี้"
"[english]dota_chatwheel_message_faceless_void_deny"	"Some things were just not meant to be."
"dota_chatwheel_label_faceless_void_deny"	"...ไม่ควรเป็นแบบนี้"
"[english]dota_chatwheel_label_faceless_void_deny"	"...just not meant to be."
"dota_chatwheel_message_faceless_void_2"	"เจ้ากลายเป็นความว่างเปล่า"
"[english]dota_chatwheel_message_faceless_void_2"	"You've been voided."
"dota_chatwheel_label_faceless_void_2"	"เจ้ากลายเป็นความว่างเปล่า"
"[english]dota_chatwheel_label_faceless_void_2"	"You've been voided."
"dota_chatwheel_message_faceless_void_3"	"ข้าทนมองไม่ได้"
"[english]dota_chatwheel_message_faceless_void_3"	"I can't bear to look."
"dota_chatwheel_label_faceless_void_3"	"ข้าทนมองไม่ได้"
"[english]dota_chatwheel_label_faceless_void_3"	"I can't bear to look."
"dota_chatwheel_message_faceless_void_4"	"ถึงแม้จะไร้หน้า แต่ข้าก็มีกระบอง"
"[english]dota_chatwheel_message_faceless_void_4"	"I may be faceless, but I'm not maceless."
"dota_chatwheel_label_faceless_void_4"	"ถึงแม้จะไร้หน้า แต่..."
"[english]dota_chatwheel_label_faceless_void_4"	"I may be faceless, but..."
"dota_chatwheel_message_faceless_void_5"	"ความอับอายชั่วกัปชั่วกัลป์!"
"[english]dota_chatwheel_message_faceless_void_5"	"An eternity of embarrassment!"
"dota_chatwheel_label_faceless_void_5"	"ความอับอายชั่วกัปชั่วกัลป์!"
"[english]dota_chatwheel_label_faceless_void_5"	"An eternity of embarrassment!"
"dota_chatwheel_message_skeleton_king_laugh"	"ฮ้า ฮ่า ฮ่า ฮ่า ฮ่า!"
"[english]dota_chatwheel_message_skeleton_king_laugh"	"AH HA HA HA HA!"
"dota_chatwheel_label_skeleton_king_laugh"	"ฮ้า ฮ่า ฮ่า ฮ่า ฮ่า!"
"[english]dota_chatwheel_label_skeleton_king_laugh"	"AH HA HA HA HA!"
"dota_chatwheel_message_skeleton_king_1"	"หมอบลงซะ เจ้าไพร่"
"[english]dota_chatwheel_message_skeleton_king_1"	"TAKE A KNEE, PEASANT."
"dota_chatwheel_label_skeleton_king_1"	"หมอบลงซะ เจ้าไพร่"
"[english]dota_chatwheel_label_skeleton_king_1"	"TAKE A KNEE, PEASANT."
"dota_chatwheel_message_skeleton_king_2"	"เยี่ยมมาก"
"[english]dota_chatwheel_message_skeleton_king_2"	"VERY NICE."
"dota_chatwheel_label_skeleton_king_2"	"เยี่ยมมาก"
"[english]dota_chatwheel_label_skeleton_king_2"	"VERY NICE."
"dota_chatwheel_message_death_prophet_laugh"	"โอ้ ฮ้า ฮ่า ฮ่า ฮ่า ฮ่า ฮ่า โฮ้ โฮ้ ฮ่าา! ฮ่า ฮ่า ฮ่า ฮ่า ฮ่า ฮ่า!"
"[english]dota_chatwheel_message_death_prophet_laugh"	"Oh ah ha ha ha ha ha ho ho haa! Ha ha ha ha ha ha!"
"dota_chatwheel_label_death_prophet_laugh"	"หัวเราะ"
"[english]dota_chatwheel_label_death_prophet_laugh"	"Laugh"
"dota_chatwheel_message_death_prophet_thank"	"เยี่ยมมาก คนดี!"
"[english]dota_chatwheel_message_death_prophet_thank"	"Well done, my beauties!"
"dota_chatwheel_label_death_prophet_thank"	"เยี่ยมมาก คนดี!"
"[english]dota_chatwheel_label_death_prophet_thank"	"Well done, my beauties!"
"dota_chatwheel_message_death_prophet_deny"	"ไม่ได้ตั้งใจจ้ะ"
"[english]dota_chatwheel_message_death_prophet_deny"	"Not meant to be."
"dota_chatwheel_label_death_prophet_deny"	"ไม่ได้ตั้งใจจ้ะ"
"[english]dota_chatwheel_label_death_prophet_deny"	"Not meant to be."
"dota_chatwheel_message_death_prophet_1"	"โถโถ น่าสงสาร"
"[english]dota_chatwheel_message_death_prophet_1"	"Poor dear."
"dota_chatwheel_label_death_prophet_1"	"โถโถ น่าสงสาร"
"[english]dota_chatwheel_label_death_prophet_1"	"Poor dear."
"dota_chatwheel_message_death_prophet_2"	"ช่างน่าผิดหวังเสียจริง"
"[english]dota_chatwheel_message_death_prophet_2"	"How disappointing."
"dota_chatwheel_label_death_prophet_2"	"ช่างน่าผิดหวังเสียจริง"
"[english]dota_chatwheel_label_death_prophet_2"	"How disappointing."
"dota_chatwheel_message_death_prophet_3"	"กลับมาหาข้าสิ! กลับมาหาข้า!"
"[english]dota_chatwheel_message_death_prophet_3"	"Come back to me! Come back to me!"
"dota_chatwheel_label_death_prophet_3"	"กลับมาหาข้าสิ!"
"[english]dota_chatwheel_label_death_prophet_3"	"Come back to me!"
"dota_chatwheel_message_death_prophet_4"	"ไม่จำเป็นต้องใช้นักพยากรณ์มาทำนายให้เจ้าเห็นถึงสิ่งนั้น"
"[english]dota_chatwheel_message_death_prophet_4"	"It did not take a prophet to see that coming."
"dota_chatwheel_label_death_prophet_4"	"ไม่จำเป็นต้องใช้นักพยากรณ์มาทำนายให้เจ้าเห็นถึงสิ่งนั้น"
"[english]dota_chatwheel_label_death_prophet_4"	"It did not take a prophet..."
"dota_chatwheel_message_death_prophet_5"	"ข้ากำลังตายไปทีละนิด"
"[english]dota_chatwheel_message_death_prophet_5"	"I died a little just now."
"dota_chatwheel_label_death_prophet_5"	"ข้ากำลังตายไปทีละนิด"
"[english]dota_chatwheel_label_death_prophet_5"	"I died a little just now."
"dota_chatwheel_message_phantom_assassin_laugh"	"โฮ้ โฮ้ โฮ้ โฮ้ โฮ้ ฮ่า ฮ่า ฮ่า"
"[english]dota_chatwheel_message_phantom_assassin_laugh"	"Ho ho ho ho ho ha ha ha"
"dota_chatwheel_label_phantom_assassin_laugh"	"หัวเราะ"
"[english]dota_chatwheel_label_phantom_assassin_laugh"	"Laugh"
"dota_chatwheel_message_phantom_assassin_thank"	"อื้มม ดีงามดั่ง Divine"
"[english]dota_chatwheel_message_phantom_assassin_thank"	"Mmm, divine."
"dota_chatwheel_label_phantom_assassin_thank"	"อื้มม ดีงามดั่ง Divine"
"[english]dota_chatwheel_label_phantom_assassin_thank"	"Mmm, divine."
"dota_chatwheel_message_phantom_assassin_deny"	"ทุกอย่างเป็นไปดั่งกลอุบาย"
"[english]dota_chatwheel_message_phantom_assassin_deny"	"All according to plan."
"dota_chatwheel_label_phantom_assassin_deny"	"ทุกอย่างเป็นไปดั่งกลอุบาย"
"[english]dota_chatwheel_label_phantom_assassin_deny"	"All according to plan."
"dota_chatwheel_message_phantom_assassin_1"	"ตายด้วยน้ำมือข้า ถือเป็นเกียรติยศ"
"[english]dota_chatwheel_message_phantom_assassin_1"	"Death at my hands is an honor."
"dota_chatwheel_label_phantom_assassin_1"	"ตายด้วยน้ำมือข้า ถือเป็นเกียรติยศ"
"[english]dota_chatwheel_label_phantom_assassin_1"	"Death at my hands is an honor."
"dota_chatwheel_message_phantom_assassin_2"	"ก็ไปได้สวยนะ ข้าว่า"
"[english]dota_chatwheel_message_phantom_assassin_2"	"That went well, I think."
"dota_chatwheel_label_phantom_assassin_2"	"ก็ไปได้สวยนะ ข้าว่า"
"[english]dota_chatwheel_label_phantom_assassin_2"	"That went well, I think."
"dota_chatwheel_message_phantom_assassin_4"	"ฮ่ะ อ้าาา ฮ่ะฮะ ไม่จ้ะ ไม่"
"[english]dota_chatwheel_message_phantom_assassin_4"	"Ha, ahhh, ha ha, no no no."
"dota_chatwheel_label_phantom_assassin_4"	"หัวเราะ...ไม่จ้ะ ไม่"
"[english]dota_chatwheel_label_phantom_assassin_4"	"Laugh...no no no."
"dota_chatwheel_message_phantom_assassin_5"	"ฉันคือเด็กสาวที่ไร้ตัวตน!"
"[english]dota_chatwheel_message_phantom_assassin_5"	"I'm an immaterial girl!"
"dota_chatwheel_label_phantom_assassin_5"	"ฉันคือเด็กสาวที่ไร้ตัวตน!"
"[english]dota_chatwheel_label_phantom_assassin_5"	"I'm an immaterial girl!"
"dota_chatwheel_message_pugna_laugh"	"ฮ่า ฮ่า ฮ่า ฮ่า ฮ่า ฮ่า"
"[english]dota_chatwheel_message_pugna_laugh"	"Ha ha ha ha ha ha."
"dota_chatwheel_label_pugna_laugh"	"หัวเราะ"
"[english]dota_chatwheel_label_pugna_laugh"	"Laugh"
"dota_chatwheel_message_pugna_1"	"โอ ข้าได้ทำแบบนั้นหรือ?"
"[english]dota_chatwheel_message_pugna_1"	"Aw, did I do that?"
"dota_chatwheel_label_pugna_1"	"โอ ข้าได้ทำแบบนั้นหรือ?"
"[english]dota_chatwheel_label_pugna_1"	"Aw, did I do that?"
"dota_chatwheel_message_pugna_2"	"มีใครคิดถึงข้าไหม?"
"[english]dota_chatwheel_message_pugna_2"	"Anyone miss me?"
"dota_chatwheel_label_pugna_2"	"มีใครคิดถึงข้าไหม?"
"[english]dota_chatwheel_label_pugna_2"	"Anyone miss me?"
"dota_chatwheel_message_pugna_3"	"ได้เวลาสร้างชื่อเสียให้ตัวเองบ้างแล้ว"
"[english]dota_chatwheel_message_pugna_3"	"Time to earn myself a bad reputation."
"dota_chatwheel_label_pugna_3"	"ได้เวลาสร้างชื่อเสีย..."
"[english]dota_chatwheel_label_pugna_3"	"Time to earn myself..."
"dota_chatwheel_message_pugna_4"	"เจ้าทำตัวเองทั้งนั้น"
"[english]dota_chatwheel_message_pugna_4"	"You did that to yourself."
"dota_chatwheel_label_pugna_4"	"เจ้าทำตัวเองทั้งนั้น"
"[english]dota_chatwheel_label_pugna_4"	"You did that to yourself."
"dota_chatwheel_message_pugna_5"	"เจ้ากำลังใช้ชีวิตอย่างไร้ค่า"
"[english]dota_chatwheel_message_pugna_5"	"You're wasting your life."
"dota_chatwheel_label_pugna_5"	"เจ้ากำลังใช้ชีวิตอย่างไร้ค่า"
"[english]dota_chatwheel_label_pugna_5"	"You're wasting your life."
"dota_chatwheel_message_templar_assassin_laugh"	"ฮ่า ฮ่า ฮ่า ฮ่า ฮ่า ฮ่า ฮ่า!"
"[english]dota_chatwheel_message_templar_assassin_laugh"	"Ha ha ha ha ha ha ha!"
"dota_chatwheel_label_templar_assassin_laugh"	"หัวเราะ"
"[english]dota_chatwheel_label_templar_assassin_laugh"	"Laugh"
"dota_chatwheel_message_templar_assassin_thank"	"ข้าจะรับไว้เอง"
"[english]dota_chatwheel_message_templar_assassin_thank"	"I'll take it."
"dota_chatwheel_label_templar_assassin_thank"	"ข้าจะรับไว้เอง"
"[english]dota_chatwheel_label_templar_assassin_thank"	"I'll take it."
"dota_chatwheel_message_templar_assassin_deny"	"ข้าได้เห็นจุดจบนั้นมาแต่ไกล"
"[english]dota_chatwheel_message_templar_assassin_deny"	"I saw that ending from miles away."
"dota_chatwheel_label_templar_assassin_deny"	"ข้าได้เห็นจุดจบนั้นมาแต่ไกล"
"[english]dota_chatwheel_label_templar_assassin_deny"	"I saw that ending from miles away."
"dota_chatwheel_message_templar_assassin_1"	"พวกเขาหาหลุมศพของเจ้าไม่เจอหรอก"
"[english]dota_chatwheel_message_templar_assassin_1"	"They'll never find your grave."
"dota_chatwheel_label_templar_assassin_1"	"พวกเขาหาหลุมศพของเจ้าไม่เจอหรอก"
"[english]dota_chatwheel_label_templar_assassin_1"	"They'll never find your grave."
"dota_chatwheel_message_templar_assassin_2"	"มันเป็นกับดัก!"
"[english]dota_chatwheel_message_templar_assassin_2"	"It's a trap!"
"dota_chatwheel_label_templar_assassin_2"	"มันเป็นกับดัก!"
"[english]dota_chatwheel_label_templar_assassin_2"	"It's a trap!"
"dota_chatwheel_message_templar_assassin_3"	"ความลึกลับลึกลงไปอีก"
"[english]dota_chatwheel_message_templar_assassin_3"	"The mystery deepens."
"dota_chatwheel_label_templar_assassin_3"	"ความลึกลับลึกลงไปอีก"
"[english]dota_chatwheel_label_templar_assassin_3"	"The mystery deepens."
"dota_chatwheel_message_templar_assassin_5"	"อ่อนให้ข้า ถ้าเจ้ากล้า"
"[english]dota_chatwheel_message_templar_assassin_5"	"Feed me if you must."
"dota_chatwheel_label_templar_assassin_5"	"อ่อนให้ข้า ถ้าเจ้ากล้า"
"[english]dota_chatwheel_label_templar_assassin_5"	"Feed me if you must."
"dota_chatwheel_message_viper_laugh"	"ถี่ฮี่ฮี่ฮี่ฮ่าร์"
"[english]dota_chatwheel_message_viper_laugh"	"Tehehehehar."
"dota_chatwheel_label_viper_laugh"	"หัวเราะ"
"[english]dota_chatwheel_label_viper_laugh"	"Laugh"
"dota_chatwheel_message_viper_thank"	"หน่วยสนับสนุนทางอากาศมาช่วยแล้ว"
"[english]dota_chatwheel_message_viper_thank"	"Air support arrives."
"dota_chatwheel_label_viper_thank"	"หน่วยสนับสนุนทางอากาศมาช่วยแล้ว"
"[english]dota_chatwheel_label_viper_thank"	"Air support arrives."
"dota_chatwheel_message_viper_deny"	"ใกล้เคียงนะแต่ยังไม่เป๊ะ"
"[english]dota_chatwheel_message_viper_deny"	"Close but not quite."
"dota_chatwheel_label_viper_deny"	"ใกล้เคียงนะแต่ยังไม่เป๊ะ"
"[english]dota_chatwheel_label_viper_deny"	"Close but not quite."
"dota_chatwheel_message_viper_1"	"ความตาย...จากเบื้องบน"
"[english]dota_chatwheel_message_viper_1"	"Death...from above."
"dota_chatwheel_label_viper_1"	"ความตาย...จากเบื้องบน"
"[english]dota_chatwheel_label_viper_1"	"Death...from above."
"dota_chatwheel_message_viper_2"	"ข้าบินไปสู่ความเดือดดาล"
"[english]dota_chatwheel_message_viper_2"	"I fly into a rage."
"dota_chatwheel_label_viper_2"	"ข้าบินไปสู่ความเดือดดาล"
"[english]dota_chatwheel_label_viper_2"	"I fly into a rage."
"dota_chatwheel_message_viper_3"	"มีความตายอื่นที่ดีกว่านี้"
"[english]dota_chatwheel_message_viper_3"	"There are better deaths."
"dota_chatwheel_label_viper_3"	"มีความตายอื่นที่ดีกว่านี้"
"[english]dota_chatwheel_label_viper_3"	"There are better deaths."
"dota_chatwheel_message_viper_4"	"แสบ...ใช่ไหมล่ะ"
"[english]dota_chatwheel_message_viper_4"	"Burns...doesn't it."
"dota_chatwheel_label_viper_4"	"แสบ...ใช่ไหมล่ะ"
"[english]dota_chatwheel_label_viper_4"	"Burns...doesn't it."
"dota_chatwheel_message_viper_5"	"จะมีขาไว้ทำไม ในเมื่อเจ้ามีปีก?"
"[english]dota_chatwheel_message_viper_5"	"Who needs legs, when you got wings?"
"dota_chatwheel_label_viper_5"	"จะมีขาไว้ทำไม ในเมื่อ..."
"[english]dota_chatwheel_label_viper_5"	"Who needs legs, when..."
"dota_chatwheel_message_luna_laugh"	"ฮ้า ฮ่า ฮ่า ฮ่า ฮ่า ฮ่า ฮ่า!"
"[english]dota_chatwheel_message_luna_laugh"	"Ah ha ha ha ha ha ha!"
"dota_chatwheel_label_luna_laugh"	"หัวเราะ"
"[english]dota_chatwheel_label_luna_laugh"	"Laugh"
"dota_chatwheel_message_luna_thank"	"พรจงประทานแด่นักรบผู้ภักดี"
"[english]dota_chatwheel_message_luna_thank"	"Blessings upon a loyal warrior."
"dota_chatwheel_label_luna_thank"	"พรจงประทานแด่นักรบผู้ภักดี"
"[english]dota_chatwheel_label_luna_thank"	"Blessings upon a loyal warrior."
"dota_chatwheel_message_luna_deny"	"น่าสนใจ!"
"[english]dota_chatwheel_message_luna_deny"	"Interesting!"
"dota_chatwheel_label_luna_deny"	"น่าสนใจ!"
"[english]dota_chatwheel_label_luna_deny"	"Interesting!"
"dota_chatwheel_message_luna_1"	"เจ้าหลงป่า ใช่ไหม?"
"[english]dota_chatwheel_message_luna_1"	"Lost in the woods, are you?"
"dota_chatwheel_label_luna_1"	"เจ้าหลงป่า ใช่ไหม?"
"[english]dota_chatwheel_label_luna_1"	"Lost in the woods, are you?"
"dota_chatwheel_message_luna_4"	"เจ้านักเวทหน้าเหียก"
"[english]dota_chatwheel_message_luna_4"	"Piece of shite wizard."
"dota_chatwheel_label_luna_4"	"เจ้านักเวทหน้าเหียก"
"[english]dota_chatwheel_label_luna_4"	"Piece of shite wizard."
"dota_chatwheel_message_dragon_knight_laugh"	"ถ่าา ฮื่อ ฮี่ ฮื้อ ฮื่อ ฮื่อ ฮื้อ"
"[english]dota_chatwheel_message_dragon_knight_laugh"	"Tehh, heh he huh heh heh huh."
"dota_chatwheel_label_dragon_knight_laugh"	"หัวเราะ"
"[english]dota_chatwheel_label_dragon_knight_laugh"	"Laugh"
"dota_chatwheel_message_dragon_knight_5"	"เผชิญหน้าต่ออัศวิน เผชิญหน้าต่อมังกร"
"[english]dota_chatwheel_message_dragon_knight_5"	"Face the knight, face the dragon."
"dota_chatwheel_label_dragon_knight_5"	"เผชิญหน้าต่ออัศวิน เผชิญหน้าต่อมังกร"
"[english]dota_chatwheel_label_dragon_knight_5"	"Face the knight, face the dragon."
"dota_chatwheel_message_dazzle_laugh"	"ฮ่า ฮ่า ฮ่าร์ ฮ่า ฮ่า ฮ่า!"
"[english]dota_chatwheel_message_dazzle_laugh"	"Ha ha har ha ha ha!"
"dota_chatwheel_label_dazzle_laugh"	"หัวเราะ"
"[english]dota_chatwheel_label_dazzle_laugh"	"Laugh"
"dota_chatwheel_message_dazzle_2"	"เจ้าช่างใจบุญเหลือเกิน"
"[english]dota_chatwheel_message_dazzle_2"	"Charitable of you."
"dota_chatwheel_label_dazzle_2"	"เจ้าช่างใจบุญเหลือเกิน"
"[english]dota_chatwheel_label_dazzle_2"	"Charitable of you."
"dota_chatwheel_message_dazzle_3"	"ซ-แซป!"
"[english]dota_chatwheel_message_dazzle_3"	"Jzap!"
"dota_chatwheel_label_dazzle_3"	"ซ-แซป!"
"[english]dota_chatwheel_label_dazzle_3"	"Jzap!"
"dota_chatwheel_message_dazzle_4"	"โดนหลอกแล้วเธอ"
"[english]dota_chatwheel_message_dazzle_4"	"Tricked you."
"dota_chatwheel_label_dazzle_4"	"โดนหลอกแล้วเธอ"
"[english]dota_chatwheel_label_dazzle_4"	"Tricked you."
"dota_chatwheel_message_dazzle_5"	"เกือบหายนะแล้วไง"
"[english]dota_chatwheel_message_dazzle_5"	"That was almost a disaster."
"dota_chatwheel_label_dazzle_5"	"เกือบหายนะแล้วไง"
"[english]dota_chatwheel_label_dazzle_5"	"That was almost a disaster."
"dota_chatwheel_message_rattletrap_laugh"	"ฮ่า ฮ่า ฮ่า ฮ่า ฮ่า ฮ่า!"
"[english]dota_chatwheel_message_rattletrap_laugh"	"Ha ha ha ha ha ha!"
"dota_chatwheel_label_rattletrap_laugh"	"หัวเราะ"
"[english]dota_chatwheel_label_rattletrap_laugh"	"Laugh"
"dota_chatwheel_message_rattletrap_2"	"ฮ่า จั๊กจี้จัง!"
"[english]dota_chatwheel_message_rattletrap_2"	"Ha, that tickles!"
"dota_chatwheel_label_rattletrap_2"	"ฮ่า จั๊กจี้จัง!"
"[english]dota_chatwheel_label_rattletrap_2"	"Ha, that tickles!"
"dota_chatwheel_message_rattletrap_3"	"โว้ว!"
"[english]dota_chatwheel_message_rattletrap_3"	"Whoa!"
"dota_chatwheel_label_rattletrap_3"	"โว้ว!"
"[english]dota_chatwheel_label_rattletrap_3"	"Whoa!"
"dota_chatwheel_message_leshrac_laugh"	"ฮ่า ฮ่า ฮ่า ฮ่า ฮ่า ฮ่า ฮ่า!"
"[english]dota_chatwheel_message_leshrac_laugh"	"Ha ha ha ha ha ha ha!"
"dota_chatwheel_label_leshrac_laugh"	"หัวเราะ"
"[english]dota_chatwheel_label_leshrac_laugh"	"Laugh"
"dota_chatwheel_message_furion_laugh"	"ม้า ฮ่า ฮ่า ฮ่า ฮ่า ฮ่า ฮ่า ฮ่า ฮ่า ฮ่า!"
"[english]dota_chatwheel_message_furion_laugh"	"Ma ha ha ha ha ha ha ha ha ha!"
"dota_chatwheel_label_furion_laugh"	"หัวเราะ"
"[english]dota_chatwheel_label_furion_laugh"	"Laugh"
"dota_chatwheel_message_furion_3"	"วิเศษมาก"
"[english]dota_chatwheel_message_furion_3"	"Very nice."
"dota_chatwheel_label_furion_3"	"วิเศษมาก"
"[english]dota_chatwheel_label_furion_3"	"Very nice."
"dota_chatwheel_message_furion_4"	"ว้าา แย่จัง"
"[english]dota_chatwheel_message_furion_4"	"Aww, too bad."
"dota_chatwheel_label_furion_4"	"ว้าา แย่จัง"
"[english]dota_chatwheel_label_furion_4"	"Aww, too bad."
"dota_chatwheel_message_life_stealer_laugh"	"ฮ่า! ฮ่า ฮ่า ฮ่า ฮ่า!"
"[english]dota_chatwheel_message_life_stealer_laugh"	"Ha! Ha ha ha ha!"
"dota_chatwheel_label_life_stealer_laugh"	"หัวเราะ"
"[english]dota_chatwheel_label_life_stealer_laugh"	"Laugh"
"dota_chatwheel_message_life_stealer_deny"	"เซอร์ไพรส์!"
"[english]dota_chatwheel_message_life_stealer_deny"	"Surprise!"
"dota_chatwheel_label_life_stealer_deny"	"เซอร์ไพรส์!"
"[english]dota_chatwheel_label_life_stealer_deny"	"Surprise!"
"dota_chatwheel_message_life_stealer_5"	"จ๊ะเอ๋!"
"[english]dota_chatwheel_message_life_stealer_5"	"Ta-da!"
"dota_chatwheel_label_life_stealer_5"	"จ๊ะเอ๋!"
"[english]dota_chatwheel_label_life_stealer_5"	"Ta-da!"
"dota_chatwheel_message_dark_seer_laugh"	"ฮี่ฮื่อ เย้ฮื้อฮื้อ เฮ้ ฮี่ฮื้ออฮี่ เย้เฮ้ เยฮี่ ฮื่อฮื้อ ฮื้อฮื้อ เย้"
"[english]dota_chatwheel_message_dark_seer_laugh"	"Heheh yeheheh hey heehhhe yehhey yehe heheh eheh yeh."
"dota_chatwheel_label_dark_seer_laugh"	"หัวเราะ"
"[english]dota_chatwheel_label_dark_seer_laugh"	"Laugh"
"dota_chatwheel_message_dark_seer_thank"	"ดีมาก"
"[english]dota_chatwheel_message_dark_seer_thank"	"Very good."
"dota_chatwheel_label_dark_seer_thank"	"ดีมาก"
"[english]dota_chatwheel_label_dark_seer_thank"	"Very good."
"dota_chatwheel_message_clinkz_laugh"	"ฮ้า ฮ่า ฮ่า ฮ่า ฮ่า"
"[english]dota_chatwheel_message_clinkz_laugh"	"Ah ha ha ha ha."
"dota_chatwheel_label_clinkz_laugh"	"หัวเราะ"
"[english]dota_chatwheel_label_clinkz_laugh"	"Laugh"
"dota_chatwheel_message_clinkz_thank"	"ทำได้ดี"
"[english]dota_chatwheel_message_clinkz_thank"	"Well done."
"dota_chatwheel_label_clinkz_thank"	"ทำได้ดี"
"[english]dota_chatwheel_label_clinkz_thank"	"Well done."
"dota_chatwheel_message_clinkz_4"	"ได้!"
"[english]dota_chatwheel_message_clinkz_4"	"Yes!"
"dota_chatwheel_label_clinkz_4"	"ได้!"
"[english]dota_chatwheel_label_clinkz_4"	"Yes!"
"dota_chatwheel_message_omniknight_laugh"	"เมี้ยวววฮื้อฮื้อ ฮื่ออ ฮืว"
"[english]dota_chatwheel_message_omniknight_laugh"	"Mehooweheh hwh hew."
"dota_chatwheel_label_omniknight_laugh"	"หัวเราะ"
"[english]dota_chatwheel_label_omniknight_laugh"	"Laugh"
"dota_chatwheel_message_omniknight_thank"	"งามยิ่งนัก"
"[english]dota_chatwheel_message_omniknight_thank"	"Beautiful."
"dota_chatwheel_label_omniknight_thank"	"งามยิ่งนัก"
"[english]dota_chatwheel_label_omniknight_thank"	"Beautiful."
"dota_chatwheel_message_enchantress_laugh"	"ฮ่า ฮ่า ฮ่า ฮ่า ฮ่า ฮ่า ฮ่า!"
"[english]dota_chatwheel_message_enchantress_laugh"	"Ha ha ha ha ha ha ha!"
"dota_chatwheel_label_enchantress_laugh"	"หัวเราะ"
"[english]dota_chatwheel_label_enchantress_laugh"	"Laugh"
"dota_chatwheel_message_enchantress_deny"	"อย่าหัวร้อน"
"[english]dota_chatwheel_message_enchantress_deny"	"Don't be mad."
"dota_chatwheel_label_enchantress_deny"	"อย่าหัวร้อน"
"[english]dota_chatwheel_label_enchantress_deny"	"Don't be mad."
"dota_chatwheel_message_enchantress_1"	"ไม่ยุติธรรมเลย"
"[english]dota_chatwheel_message_enchantress_1"	"It's just not fair."
"dota_chatwheel_label_enchantress_1"	"ไม่ยุติธรรมเลย"
"[english]dota_chatwheel_label_enchantress_1"	"It's just not fair."
"dota_chatwheel_message_enchantress_2"	"ตลกชะมัด"
"[english]dota_chatwheel_message_enchantress_2"	"Hilarious."
"dota_chatwheel_label_enchantress_2"	"ตลกชะมัด"
"[english]dota_chatwheel_label_enchantress_2"	"Hilarious."
"dota_chatwheel_message_enchantress_3"	"เธอทำดีที่สุดแล้ว"
"[english]dota_chatwheel_message_enchantress_3"	"You did your best."
"dota_chatwheel_label_enchantress_3"	"เธอทำดีที่สุดแล้ว"
"[english]dota_chatwheel_label_enchantress_3"	"You did your best."
"dota_chatwheel_message_enchantress_4"	"ดึ๋ง"
"[english]dota_chatwheel_message_enchantress_4"	"Sproink."
"dota_chatwheel_label_enchantress_4"	"ดึ๋ง"
"[english]dota_chatwheel_label_enchantress_4"	"Sproink."
"dota_chatwheel_message_huskar_laugh"	"ฮื่อ ฮื่อ ฮื่ออ"
"[english]dota_chatwheel_message_huskar_laugh"	"Heh heh heeh."
"dota_chatwheel_label_huskar_laugh"	"หัวเราะ"
"[english]dota_chatwheel_label_huskar_laugh"	"Laugh"
"dota_chatwheel_message_huskar_2"	"คุ้มจังเลย!"
"[english]dota_chatwheel_message_huskar_2"	"A fair trade!"
"dota_chatwheel_label_huskar_2"	"คุ้มจังเลย!"
"[english]dota_chatwheel_label_huskar_2"	"A fair trade!"
"dota_chatwheel_message_huskar_4"	"แค่นี้เหรอ?"
"[english]dota_chatwheel_message_huskar_4"	"Is that all?"
"dota_chatwheel_label_huskar_4"	"แค่นี้เหรอ?"
"[english]dota_chatwheel_label_huskar_4"	"Is that all?"
"dota_chatwheel_message_huskar_5"	"เจ้าทำดีแล้ว แต่ยังดีไม่พอ"
"[english]dota_chatwheel_message_huskar_5"	"You gave all you could give but it was not enough."
"dota_chatwheel_label_huskar_5"	"เจ้าทำดีแล้ว..."
"[english]dota_chatwheel_label_huskar_5"	"You gave all you could give..."
"dota_chatwheel_message_night_stalker_laugh"	"ฮื่อ ฮื่อ ฮื่อ ฮ่าา ฮื่อ ฮื่ออออ"
"[english]dota_chatwheel_message_night_stalker_laugh"	"Heh heh heh hah heh hehhhh."
"dota_chatwheel_label_night_stalker_laugh"	"หัวเราะ"
"[english]dota_chatwheel_label_night_stalker_laugh"	"Laugh"
"dota_chatwheel_message_night_stalker_4"	"ได้เวลาหาอาหาร"
"[english]dota_chatwheel_message_night_stalker_4"	"It's feeding time."
"dota_chatwheel_label_night_stalker_4"	"ได้เวลาหาอาหาร"
"[english]dota_chatwheel_label_night_stalker_4"	"It's feeding time."
"dota_chatwheel_message_broodmother_laugh"	"ฮ่า ฮ่า ฮ่า ฮ่า ฮ่า"
"[english]dota_chatwheel_message_broodmother_laugh"	"Ha ha ha ha ha."
"dota_chatwheel_label_broodmother_laugh"	"หัวเราะ"
"[english]dota_chatwheel_label_broodmother_laugh"	"Laugh"
"dota_chatwheel_message_broodmother_1"	"อร่อยจัง"
"[english]dota_chatwheel_message_broodmother_1"	"Delicious."
"dota_chatwheel_label_broodmother_1"	"อร่อยจัง"
"[english]dota_chatwheel_label_broodmother_1"	"Delicious."
"dota_chatwheel_message_broodmother_2"	"เจ้าไม่ได้กลัวแมงมุมใช่ไหม?"
"[english]dota_chatwheel_message_broodmother_2"	"You're not afraid of spiders, are you?"
"dota_chatwheel_label_broodmother_2"	"เจ้าไม่ได้กลัวแมงมุมใช่ไหม?"
"[english]dota_chatwheel_label_broodmother_2"	"You're not afraid of spiders, are you?"
"dota_chatwheel_message_bounty_hunter_laugh"	"ฮ้า ฮ่า ฮ่า ฮ่า ฮ่า ฮ่า ฮ่า ฮ่า ฮ่า"
"[english]dota_chatwheel_message_bounty_hunter_laugh"	"Ah ha ha ha ha ha ha ha ha."
"dota_chatwheel_label_bounty_hunter_laugh"	"หัวเราะ"
"[english]dota_chatwheel_label_bounty_hunter_laugh"	"Laugh"
"dota_chatwheel_message_bounty_hunter_1"	"ธุรกิจน่ะ ไม่ใช่เรื่องส่วนตัว"
"[english]dota_chatwheel_message_bounty_hunter_1"	"Just business, nothing personal."
"dota_chatwheel_label_bounty_hunter_1"	"ธุรกิจน่ะ..."
"[english]dota_chatwheel_label_bounty_hunter_1"	"Just business..."
"dota_chatwheel_message_weaver_laugh"	"ฮี่ฮื่อฮี่ฮ่าา!"
"[english]dota_chatwheel_message_weaver_laugh"	"Hehehhehah!"
"dota_chatwheel_label_weaver_laugh"	"หัวเราะ"
"[english]dota_chatwheel_label_weaver_laugh"	"Laugh"
"dota_chatwheel_message_weaver_deny"	"คิดว่าจัดการฉันได้แล้วใช่ไหมล่ะ?"
"[english]dota_chatwheel_message_weaver_deny"	"You thought you had me, didn't you?"
"dota_chatwheel_message_jakiro_laugh"	"ฮ่า ฮ่า ฮ่า ฮ่า ฮ่า ฮ่า ฮ่า ฮ่า ฮ่า ฮ่า ฮ่า!"
"[english]dota_chatwheel_message_jakiro_laugh"	"Ha ha ha ha ha ha ha ha ha ha ha!"
"dota_chatwheel_label_jakiro_laugh"	"หัวเราะ"
"[english]dota_chatwheel_label_jakiro_laugh"	"Laugh"
"dota_chatwheel_message_jakiro_thank"	"ขอบใจ"
"[english]dota_chatwheel_message_jakiro_thank"	"Cheers."
"dota_chatwheel_label_jakiro_thank"	"ขอบใจ"
"[english]dota_chatwheel_label_jakiro_thank"	"Cheers."
"dota_chatwheel_message_jakiro_1"	"เผาเป็นผุยผง"
"[english]dota_chatwheel_message_jakiro_1"	"Burninated."
"dota_chatwheel_label_jakiro_1"	"เผาเป็นผุยผง!"
"[english]dota_chatwheel_label_jakiro_1"	"Burninated!"
"dota_chatwheel_message_batrider_laugh"	"ฮี่ ฮ่า ฮ่า!"
"[english]dota_chatwheel_message_batrider_laugh"	"He ha ha!"
"dota_chatwheel_label_batrider_laugh"	"หัวเราะ"
"[english]dota_chatwheel_label_batrider_laugh"	"Laugh"
"dota_chatwheel_message_batrider_1"	"โอ้ว เย้ เราจะขี่มุ่งสู่อาทิตย์อัสดง!"
"[english]dota_chatwheel_message_batrider_1"	"Aw yeah, off we ride into the sunset."
"dota_chatwheel_label_batrider_1"	"มุ่งสู่อาทิตย์อัสดง!"
"[english]dota_chatwheel_label_batrider_1"	"Into the sunset!"
"dota_chatwheel_message_chen_laugh"	"ฮี่ฮี่ฮื่มฮื่มฮืมมม"
"[english]dota_chatwheel_message_chen_laugh"	"Hehehmehmehmmm."
"dota_chatwheel_label_chen_laugh"	"หัวเราะ"
"[english]dota_chatwheel_label_chen_laugh"	"Laugh"
"dota_chatwheel_message_chen_thank"	"โอ้ ขอบคุณพระเจ้า"
"[english]dota_chatwheel_message_chen_thank"	"Oh, thank God."
"dota_chatwheel_label_chen_thank"	"โอ้ ขอบคุณพระเจ้า"
"[english]dota_chatwheel_label_chen_thank"	"Oh, thank God."
"dota_chatwheel_message_chen_deny"	"เจ้าหนีบาปตัวเองไม่พ้นหรอก"
"[english]dota_chatwheel_message_chen_deny"	"Can't escape your sins."
"dota_chatwheel_label_chen_deny"	"เจ้าหนีบาปตัวเองไม่พ้นหรอก"
"[english]dota_chatwheel_label_chen_deny"	"You can't escape your sins."
"dota_chatwheel_message_chen_1"	"เจอแล้วพวกมิคู่ควร"
"[english]dota_chatwheel_message_chen_1"	"Found unworthy."
"dota_chatwheel_label_chen_1"	"เจอแล้วพวกมิคู่ควร"
"[english]dota_chatwheel_label_chen_1"	"Found unworthy."
"dota_chatwheel_message_chen_2"	"ช่างเหยียดหยามอะไรเยี่ยงนี้?"
"[english]dota_chatwheel_message_chen_2"	"What blasphemy is this?"
"dota_chatwheel_label_chen_2"	"ช่างเหยียดหยาม..."
"[english]dota_chatwheel_label_chen_2"	"What blasphemy..."
"dota_chatwheel_message_chen_3"	"เวลาใกล้เข้ามาแล้ว"
"[english]dota_chatwheel_message_chen_3"	"The time draws nigh."
"dota_chatwheel_label_chen_3"	"เวลาใกล้เข้ามาแล้ว"
"[english]dota_chatwheel_label_chen_3"	"The time draws nigh."
"dota_chatwheel_message_chen_4"	"ได้ฤกษ์เริ่มลงทัณฑ์!"
"[english]dota_chatwheel_message_chen_4"	"The persecution starts now!"
"dota_chatwheel_label_chen_4"	"เริ่มลงทัณฑ์..."
"[english]dota_chatwheel_label_chen_4"	"The persecution..."
"dota_chatwheel_message_chen_5"	"เดินแผนตามคำทำนาย"
"[english]dota_chatwheel_message_chen_5"	"A fulfillment of the prophecy."
"dota_chatwheel_label_chen_5"	"เดินแผนตามคำทำนาย"
"[english]dota_chatwheel_label_chen_5"	"A fulfillment of the prophecy."
"dota_chatwheel_message_spectre_laugh"	"ฮ่า ฮ่า ฮ่า ฮ่า ฮ่า ฮ่า ฮ่า ฮ่า ฮ่า!"
"[english]dota_chatwheel_message_spectre_laugh"	"Ha ha ha ha ha ha ha ha ha!"
"dota_chatwheel_label_spectre_laugh"	"[หัวเราะ]"
"[english]dota_chatwheel_label_spectre_laugh"	"[Laugh]"
"dota_chatwheel_message_spectre_thank"	"ข้าจะอยู่เคียงข้างเจ้า"
"[english]dota_chatwheel_message_spectre_thank"	"I'll stand by you."
"dota_chatwheel_label_spectre_thank"	"ข้าจะอยู่เคียงข้างเจ้า"
"[english]dota_chatwheel_label_spectre_thank"	"I'll stand by you."
"dota_chatwheel_message_spectre_deny"	"พลาด"
"[english]dota_chatwheel_message_spectre_deny"	"Wrong."
"dota_chatwheel_label_spectre_deny"	"พลาด"
"[english]dota_chatwheel_label_spectre_deny"	"Wrong."
"dota_chatwheel_message_spectre_1"	"ข้าไม่เข้าใจ"
"[english]dota_chatwheel_message_spectre_1"	"I do not understand."
"dota_chatwheel_label_spectre_1"	"ข้าไม่เข้าใจ"
"[english]dota_chatwheel_label_spectre_1"	"I do not understand."
"dota_chatwheel_message_spectre_2"	"นี่มันอะไรกัน?"
"[english]dota_chatwheel_message_spectre_2"	"What is this?"
"dota_chatwheel_label_spectre_2"	"นี่มันอะไรกัน?"
"[english]dota_chatwheel_label_spectre_2"	"What is this?"
"dota_chatwheel_message_spectre_4"	"ไม่ต้องมีใครเข้าใจข้าจะได้ไหม?"
"[english]dota_chatwheel_message_spectre_4"	"Can no one understand me?"
"dota_chatwheel_label_spectre_4"	"ไม่ต้องมีใครเข้าใจข้าจะได้ไหม?"
"[english]dota_chatwheel_label_spectre_4"	"Can no one understand me?"
"dota_chatwheel_message_ancient_apparition_laugh"	"ฮื้ม ฮื้ม ฮื้ม ฮ่า ฮ่า ฮ่า ฮ่า ฮ่า ฮ่า ฮ่า!"
"[english]dota_chatwheel_message_ancient_apparition_laugh"	"Hm hm hm ha ha ha ha ha ha ha!"
"dota_chatwheel_label_ancient_apparition_laugh"	"หัวเราะ"
"[english]dota_chatwheel_label_ancient_apparition_laugh"	"Laugh"
"dota_chatwheel_message_ancient_apparition_thank"	"น่าสนใจ"
"[english]dota_chatwheel_message_ancient_apparition_thank"	"Interesting."
"dota_chatwheel_label_ancient_apparition_thank"	"น่าสนใจ"
"[english]dota_chatwheel_label_ancient_apparition_thank"	"Interesting."
"dota_chatwheel_message_ancient_apparition_5"	"หมอกน้ำแข็ง!"
"[english]dota_chatwheel_message_ancient_apparition_5"	"Icefog!"
"dota_chatwheel_message_doom_bringer_laugh"	"ฮี่ฮื่อ ฮื่อ ฮ่าา ฮื่อ ฮ่าา ฮ่าา ฮ่าา"
"[english]dota_chatwheel_message_doom_bringer_laugh"	"Heheh heh hah heh hah hah hah."
"dota_chatwheel_label_doom_bringer_laugh"	"หัวเราะ"
"[english]dota_chatwheel_label_doom_bringer_laugh"	"Laugh"
"dota_chatwheel_message_doom_bringer_thank"	"โอ้ ใช่"
"[english]dota_chatwheel_message_doom_bringer_thank"	"Oh, yes."
"dota_chatwheel_label_doom_bringer_thank"	"โอ้ ใช่"
"[english]dota_chatwheel_label_doom_bringer_thank"	"Oh, yes."
"dota_chatwheel_message_doom_bringer_3"	"โอ้ แย่จัง"
"[english]dota_chatwheel_message_doom_bringer_3"	"Oh, crap."
"dota_chatwheel_label_doom_bringer_3"	"โอ้ แย่จัง!"
"[english]dota_chatwheel_label_doom_bringer_3"	"Oh, crap!"
"dota_chatwheel_message_ursa_laugh"	"ฮ่าา! ฮ่าา! ฮ่าา-ฮ่าา-ฮ่าา!"
"[english]dota_chatwheel_message_ursa_laugh"	"Hah! Hah! Hah-hah-hah!"
"dota_chatwheel_label_ursa_laugh"	"หัวเราะ"
"[english]dota_chatwheel_label_ursa_laugh"	"Laugh"
"dota_chatwheel_message_ursa_thank"	"ถึงฤดูใบไม้ผลิแล้วหรือ?"
"[english]dota_chatwheel_message_ursa_thank"	"Is it spring already?"
"dota_chatwheel_label_ursa_thank"	"ถึงฤดูใบไม้ผลิแล้วหรือ?"
"[english]dota_chatwheel_label_ursa_thank"	"Is it spring already?"
"dota_chatwheel_message_ursa_4"	"หวานปานน้ำผึ้ง"
"[english]dota_chatwheel_message_ursa_4"	"Sweet as honey."
"dota_chatwheel_label_ursa_4"	"หวานปานน้ำผึ้ง"
"[english]dota_chatwheel_label_ursa_4"	"Sweet as honey."
"dota_chatwheel_message_spirit_breaker_laugh"	"ฮั้วฮี่ฮี่ฮี่ฮ้าฮ้าฮ้า"
"[english]dota_chatwheel_message_spirit_breaker_laugh"	"Whoheheheahahah."
"dota_chatwheel_label_spirit_breaker_laugh"	"หัวเราะ"
"[english]dota_chatwheel_label_spirit_breaker_laugh"	"Laugh"
"dota_chatwheel_message_gyrocopter_laugh"	"ฮ้า ฮ่า! ฮ้าา ฮ่าฮ่า ฮ่า ฮ่า! ฮ้า ฮ่า ฮ่าาา"
"[english]dota_chatwheel_message_gyrocopter_laugh"	"Ah ha! Wah haha ha ha! Ah ha hhuh."
"dota_chatwheel_label_gyrocopter_laugh"	"หัวเราะ"
"[english]dota_chatwheel_label_gyrocopter_laugh"	"Laugh"
"dota_chatwheel_message_gyrocopter_deny"	"อ๊าก โธ่เว้ย!"
"[english]dota_chatwheel_message_gyrocopter_deny"	"Aaah phooey."
"dota_chatwheel_label_gyrocopter_deny"	"อ๊าก โธ่เว้ย!"
"[english]dota_chatwheel_label_gyrocopter_deny"	"Aaah phooey!"
"dota_chatwheel_message_gyrocopter_1"	"โชคดีไป!"
"[english]dota_chatwheel_message_gyrocopter_1"	"Lucky!"
"dota_chatwheel_label_gyrocopter_1"	"โชคดีไป!"
"[english]dota_chatwheel_label_gyrocopter_1"	"Lucky!"
"dota_chatwheel_message_alchemist_laugh"	"ฮ่า ฮ่า ฮ่า ฮ่า ฮ่า!"
"[english]dota_chatwheel_message_alchemist_laugh"	"Ha ha ha ha ha!"
"dota_chatwheel_label_alchemist_laugh"	"หัวเราะ"
"[english]dota_chatwheel_label_alchemist_laugh"	"Laugh"
"dota_chatwheel_message_alchemist_1"	"ว่าไงทุกคน!"
"[english]dota_chatwheel_message_alchemist_1"	"Hey, everybody!"
"dota_chatwheel_label_alchemist_1"	"ว่าไงทุกคน"
"[english]dota_chatwheel_label_alchemist_1"	"Hey everybody."
"dota_chatwheel_message_alchemist_4"	"เละตุ้มเป๊ะ!"
"[english]dota_chatwheel_message_alchemist_4"	"What a mess!"
"dota_chatwheel_label_alchemist_4"	"เละตุ้มเป๊ะ!"
"[english]dota_chatwheel_label_alchemist_4"	"What a mess!"
"dota_chatwheel_message_invoker_laugh"	"ฮ่า ฮ่า ฮ่า ฮ่า ฮ่า ฮ่า ฮ่า ฮ่า ฮ่า ฮ่า!"
"[english]dota_chatwheel_message_invoker_laugh"	"Ha ha ha ha ha ha ha ha ha ha!"
"dota_chatwheel_label_invoker_laugh"	"หัวเราะ"
"[english]dota_chatwheel_label_invoker_laugh"	"Laugh"
"dota_chatwheel_message_invoker_2"	"สู้ข้าสิ!"
"[english]dota_chatwheel_message_invoker_2"	"Fight me!"
"dota_chatwheel_label_invoker_2"	"สู้ข้าสิ!"
"[english]dota_chatwheel_label_invoker_2"	"Fight me!"
"dota_chatwheel_message_silencer_laugh"	"ฮ้า ฮ่า ฮ่า"
"[english]dota_chatwheel_message_silencer_laugh"	"Ah ha ha."
"dota_chatwheel_label_silencer_laugh"	"หัวเราะ"
"[english]dota_chatwheel_label_silencer_laugh"	"Laugh"
"dota_chatwheel_message_silencer_1"	"สงบไว้พวกเจ้า"
"[english]dota_chatwheel_message_silencer_1"	"Calm yourselves."
"dota_chatwheel_label_silencer_1"	"สงบไว้พวกเจ้า"
"[english]dota_chatwheel_label_silencer_1"	"Calm yourselves"
"dota_chatwheel_message_silencer_3"	"เงียบเสีย เจ้าโง่!"
"[english]dota_chatwheel_message_silencer_3"	"Silence, fool!"
"dota_chatwheel_label_silencer_3"	"เงียบเสีย เจ้าโง่"
"[english]dota_chatwheel_label_silencer_3"	"Silence, fool."
"dota_chatwheel_message_silencer_5"	"ชู่ววว์ ได้ยินอะไรกันไหม?"
"[english]dota_chatwheel_message_silencer_5"	"Shhh, did you hear something?"
"dota_chatwheel_label_silencer_5"	"ชู่ววว์ ได้ยินอะไรกันไหม?"
"[english]dota_chatwheel_label_silencer_5"	"Shhh, did you hear something?"
"dota_chatwheel_message_obsidian_destroyer_laugh"	"ฮ่า ฮ่า ฮ่า ฮ่า ฮ่า ฮ่า ฮ่า ฮ่า ฮ่า!"
"[english]dota_chatwheel_message_obsidian_destroyer_laugh"	"Ha ha ha ha ha ha ha ha ha!"
"dota_chatwheel_label_obsidian_destroyer_laugh"	"หัวเราะ"
"[english]dota_chatwheel_label_obsidian_destroyer_laugh"	"Laugh"
"dota_chatwheel_message_lycan_laugh"	"ฮ้า ฮ่า ฮ่า ฮ่า ฮ่า ฮ่า ฮ่า ฮ่า"
"[english]dota_chatwheel_message_lycan_laugh"	"Ah ha ha ha ha ha ha ha."
"dota_chatwheel_label_lycan_laugh"	"หัวเราะ"
"[english]dota_chatwheel_label_lycan_laugh"	"Laugh"
"dota_chatwheel_message_brewmaster_laugh"	"ฮี่ฮ่าาฮี่ฮ่าา"
"[english]dota_chatwheel_message_brewmaster_laugh"	"Hehaahehah."
"dota_chatwheel_label_brewmaster_laugh"	"หัวเราะ"
"[english]dota_chatwheel_label_brewmaster_laugh"	"Laugh"
"dota_chatwheel_message_shadow_demon_laugh"	"ฮ่า ฮ่า ฮ่า ฮ่า ฮ่า ฮ่า ฮ่า ฮ่า ฮ่า ฮ่า"
"[english]dota_chatwheel_message_shadow_demon_laugh"	"Ha ha ha ha ha ha ha ha ha ha."
"dota_chatwheel_label_shadow_demon_laugh"	"หัวเราะ"
"[english]dota_chatwheel_label_shadow_demon_laugh"	"Laugh"
"dota_chatwheel_message_shadow_demon_4"	"กราบซะ"
"[english]dota_chatwheel_message_shadow_demon_4"	"Bow down."
"dota_chatwheel_label_shadow_demon_4"	"กราบซะ"
"[english]dota_chatwheel_label_shadow_demon_4"	"Bow down."
"dota_chatwheel_message_shadow_demon_5"	"ร้องอีกสิ"
"[english]dota_chatwheel_message_shadow_demon_5"	"Cry some more."
"dota_chatwheel_label_shadow_demon_5"	"ร้องอีกสิ"
"[english]dota_chatwheel_label_shadow_demon_5"	"Cry some more."
"dota_chatwheel_message_lone_druid_laugh"	"ฮ้า ฮ่า ฮ่า ฮ่า ฮ่า ฮ่าา!"
"[english]dota_chatwheel_message_lone_druid_laugh"	"Ah ha ha ha ha hah!"
"dota_chatwheel_label_lone_druid_laugh"	"หัวเราะ"
"[english]dota_chatwheel_label_lone_druid_laugh"	"Laugh"
"dota_chatwheel_message_lone_druid_1"	"สานพลัง!"
"[english]dota_chatwheel_message_lone_druid_1"	"Synergy!"
"dota_chatwheel_label_lone_druid_1"	"สานพลัง!"
"[english]dota_chatwheel_label_lone_druid_1"	"Synergy!"
"dota_chatwheel_message_chaos_knight_laugh"	"โอ โฮ้ โฮ้ ฮ่า ฮ่า ฮ่า ฮ่า ฮ่า ฮ่า ฮ่า ฮ่า ฮ่า ฮ่า ฮ่า!"
"[english]dota_chatwheel_message_chaos_knight_laugh"	"Oo ho ho ha ha ha ha ha ha ha ha ha ha ha!"
"dota_chatwheel_label_chaos_knight_laugh"	"หัวเราะ"
"[english]dota_chatwheel_label_chaos_knight_laugh"	"Laugh"
"dota_chatwheel_message_meepo_laugh"	"เฮี้ย เฮี้ยเฮี้ยฮ่า ฮ่า ฮ่า ฮ่า!"
"[english]dota_chatwheel_message_meepo_laugh"	"Hnya Hnyahnyaha ha ha ha!"
"dota_chatwheel_label_meepo_laugh"	"หัวเราะ"
"[english]dota_chatwheel_label_meepo_laugh"	"Laugh"
"dota_chatwheel_message_meepo_deny"	"เป็นไงบ้าง?"
"[english]dota_chatwheel_message_meepo_deny"	"How ya doin?"
"dota_chatwheel_label_meepo_deny"	"เป็นไงบ้าง?"
"[english]dota_chatwheel_label_meepo_deny"	"How ya doin?"
"dota_chatwheel_message_meepo_3"	"นี่มันเรื่องโคตรจะน่าอายเลย"
"[english]dota_chatwheel_message_meepo_3"	"This is a real freakin' embarrasment."
"dota_chatwheel_label_meepo_3"	"นี่มันเรื่องโคตรจะน่าอายเลย"
"[english]dota_chatwheel_label_meepo_3"	"This is a real freakin' embarrasment."
"dota_chatwheel_message_treant_laugh"	"ฮ้า โฮ้ โฮ้ โฮ้ โฮ้วววว โฮ้ โฮ้ โฮ้ ฮื้ม ฮื้ม ฮื้ม"
"[english]dota_chatwheel_message_treant_laugh"	"Ah ho ho ho hoooo ho ho ho hm hm hm."
"dota_chatwheel_label_treant_laugh"	"หัวเราะ"
"[english]dota_chatwheel_label_treant_laugh"	"Laugh"
"dota_chatwheel_message_treant_1"	"เจ้าหลงป่าหรือ?"
"[english]dota_chatwheel_message_treant_1"	"Are you lost?"
"dota_chatwheel_label_treant_1"	"เจ้าหลงป่าหรือ?"
"[english]dota_chatwheel_label_treant_1"	"Are you lost?"
"dota_chatwheel_message_treant_2"	"ระวังหน่อย"
"[english]dota_chatwheel_message_treant_2"	"Careful."
"dota_chatwheel_label_treant_2"	"ระวังหน่อย"
"[english]dota_chatwheel_label_treant_2"	"Careful."
"dota_chatwheel_message_treant_4"	"อ้า ปุ๋ยสด"
"[english]dota_chatwheel_message_treant_4"	"Ah, fresh fertilizer."
"dota_chatwheel_label_treant_4"	"อ้า ปุ๋ยสด"
"[english]dota_chatwheel_label_treant_4"	"Ah, fresh fertilizer."
"dota_chatwheel_message_treant_5"	"หืม? เกิดอะไรขึ้น?"
"[english]dota_chatwheel_message_treant_5"	"Mmm? What happened?"
"dota_chatwheel_label_treant_5"	"เกิดอะไรขึ้น?"
"[english]dota_chatwheel_label_treant_5"	"What happened?"
"dota_chatwheel_message_ogre_magi_laugh"	"ฮื่อ ฮื่อ ฮี่ ฮี่ ฮี่ ฮี่ ฮี่ ฮ้าา ฮ่า... เรากำลังหัวเราะอะไรกันเนี่ย?"
"[english]dota_chatwheel_message_ogre_magi_laugh"	"Hee hee he he he he he aha ha... What're we laughing about?"
"dota_chatwheel_label_ogre_magi_laugh"	"หัวเราะ"
"[english]dota_chatwheel_label_ogre_magi_laugh"	"Laugh"
"dota_chatwheel_message_ogre_magi_thank"	"นั่นเพราะฝีมือเลยรู้มั้ย ฝีมือล้วน ๆ"
"[english]dota_chatwheel_message_ogre_magi_thank"	"That was skill all right. Pure skill."
"dota_chatwheel_label_ogre_magi_thank"	"ฝีมือล้วน ๆ"
"[english]dota_chatwheel_label_ogre_magi_thank"	"Pure skill."
"dota_chatwheel_label_ogre_magi_2"	"ทำได้ดี!"
"[english]dota_chatwheel_label_ogre_magi_2"	"Good work!"
"dota_chatwheel_message_undying_laugh"	"ฮื่อ ฮื่อ ฮื่อ ฮื่อ ฮ่า ฮ่า ฮ่า ฮ่า ฮ่า ฮ่า ฮ่า ฮ่า ฮ่า ฮ่า!"
"[english]dota_chatwheel_message_undying_laugh"	"Heh heh heh heh ha ha ha ha ha ha ha ha ha ha!"
"dota_chatwheel_label_undying_laugh"	"หัวเราะ"
"[english]dota_chatwheel_label_undying_laugh"	"Laugh"
"dota_chatwheel_message_undying_1"	"ข้าเกลียดชีวิต"
"[english]dota_chatwheel_message_undying_1"	"I hate life."
"dota_chatwheel_label_undying_1"	"ข้าเกลียดชีวิต"
"[english]dota_chatwheel_label_undying_1"	"I hate life"
"dota_chatwheel_message_rubick_laugh"	"ฮ้า ฮ่า ฮ่า! ฮี้ ฮี่ ฮี่ ฮี่ ฮี่ ฮี่ ฮี่ ฮี่ ฮี่ ฮี่!"
"[english]dota_chatwheel_message_rubick_laugh"	"Ah ha ha! Eh he he he he he he he he he!"
"dota_chatwheel_label_rubick_laugh"	"หัวเราะ"
"[english]dota_chatwheel_label_rubick_laugh"	"Laugh"
"dota_chatwheel_message_rubick_thank"	"ความคิดเลิศประเสริฐศรี!"
"[english]dota_chatwheel_message_rubick_thank"	"Excellent idea!"
"dota_chatwheel_label_rubick_thank"	"ความคิดเลิศประเสริฐศรี!"
"[english]dota_chatwheel_label_rubick_thank"	"Excellent idea!"
"dota_chatwheel_message_rubick_deny"	"ข้าเกือบจะรู้สึกแย่"
"[english]dota_chatwheel_message_rubick_deny"	"I almost feel bad."
"dota_chatwheel_label_rubick_deny"	"ข้าเกือบจะรู้สึกแย่"
"[english]dota_chatwheel_label_rubick_deny"	"I almost feel bad."
"dota_chatwheel_message_rubick_1"	"มันแค่กระตุ้นข้านิด ๆ!"
"[english]dota_chatwheel_message_rubick_1"	"That perked me up a bit!"
"dota_chatwheel_label_rubick_1"	"มันแค่กระตุ้น!"
"[english]dota_chatwheel_label_rubick_1"	"That perked me up!"
"dota_chatwheel_message_rubick_2"	"ชื่อเจ้ามันขัดใจข้า"
"[english]dota_chatwheel_message_rubick_2"	"Your name offends me."
"dota_chatwheel_label_rubick_2"	"ชื่อเจ้ามันขัดใจข้า"
"[english]dota_chatwheel_label_rubick_2"	"Your name offends me."
"dota_chatwheel_message_rubick_3"	"ช่างน่าอัศจรรย์ใจ!"
"[english]dota_chatwheel_message_rubick_3"	"What a surprise!"
"dota_chatwheel_label_rubick_3"	"ช่างน่าอัศจรรย์ใจ!"
"[english]dota_chatwheel_label_rubick_3"	"What a surprise!"
"dota_chatwheel_message_rubick_4"	"อุ๊ปส์!"
"[english]dota_chatwheel_message_rubick_4"	"Whoops!"
"dota_chatwheel_label_rubick_4"	"อุ๊ปส์!"
"[english]dota_chatwheel_label_rubick_4"	"Whoops!"
"dota_chatwheel_message_rubick_5"	"วิจิตร! วิจิตรพิสดารเสียยิ่งกระไร!"
"[english]dota_chatwheel_message_rubick_5"	"Exquisite! Absolutely exquisite!"
"dota_chatwheel_label_rubick_5"	"วิจิตร!"
"[english]dota_chatwheel_label_rubick_5"	"Exquisite!"
"dota_chatwheel_message_disruptor_laugh"	"ฮี่ฮี่ฮ่า"
"[english]dota_chatwheel_message_disruptor_laugh"	"Heheha."
"dota_chatwheel_label_disruptor_laugh"	"หัวเราะ"
"[english]dota_chatwheel_label_disruptor_laugh"	"Laugh"
"dota_chatwheel_message_disruptor_5"	"ฮ่า ดูนั่นสิ"
"[english]dota_chatwheel_message_disruptor_5"	"Well, look at that."
"dota_chatwheel_label_disruptor_5"	"ดูนั่นสิ"
"[english]dota_chatwheel_label_disruptor_5"	"Look at that"
"dota_chatwheel_message_nyx_assassin_laugh"	"ฮี้ฮื่อฮื่อ นิกซ์, นิกซ์"
"[english]dota_chatwheel_message_nyx_assassin_laugh"	"Heehehheh Nyx, Nyx."
"dota_chatwheel_label_nyx_assassin_laugh"	"หัวเราะ"
"[english]dota_chatwheel_label_nyx_assassin_laugh"	"Laugh"
"dota_chatwheel_message_nyx_assassin_thank"	"แจ๋ว"
"[english]dota_chatwheel_message_nyx_assassin_thank"	"Nice."
"dota_chatwheel_label_nyx_assassin_thank"	"แจ๋ว"
"[english]dota_chatwheel_label_nyx_assassin_thank"	"Nice."
"dota_chatwheel_message_nyx_assassin_1"	"ไร้ความสามารถ"
"[english]dota_chatwheel_message_nyx_assassin_1"	"Talentless."
"dota_chatwheel_label_nyx_assassin_1"	"ไร้ความสามารถ"
"[english]dota_chatwheel_label_nyx_assassin_1"	"Talentless"
"dota_chatwheel_message_nyx_assassin_2"	"นิกซ์ ฉึฉึกฉึฉึกฉึฉึก"
"[english]dota_chatwheel_message_nyx_assassin_2"	"Nyx chichcichcihcihchi."
"dota_chatwheel_label_nyx_assassin_2"	"นิกซ์ ฉึฉึกฉึฉึกฉึฉึก"
"[english]dota_chatwheel_label_nyx_assassin_2"	"Nyx chichcichcihcihchi."
"dota_chatwheel_message_nyx_assassin_4"	"เก็บไปอีกหนึ่ง"
"[english]dota_chatwheel_message_nyx_assassin_4"	"Assassinated."
"dota_chatwheel_label_nyx_assassin_4"	"เก็บไปอีกหนึ่ง"
"[english]dota_chatwheel_label_nyx_assassin_4"	"Assassinated."
"dota_chatwheel_message_nyx_assassin_5"	"นิกซ์ นิกซ์ นิกซ์ นิกซ์"
"[english]dota_chatwheel_message_nyx_assassin_5"	"Nyx, Nyx, Nyx, Nyx."
"dota_chatwheel_label_nyx_assassin_5"	"นิกซ์ นิกซ์ นิกซ์ นิกซ์"
"[english]dota_chatwheel_label_nyx_assassin_5"	"Nyx, Nyx, Nyx, Nyx."
"dota_chatwheel_message_naga_siren_laugh"	"ฮ้าฮี้ฮี้ฮ้าฮี้"
"[english]dota_chatwheel_message_naga_siren_laugh"	"Ahehehaheh."
"dota_chatwheel_label_naga_siren_laugh"	"หัวเราะ"
"[english]dota_chatwheel_label_naga_siren_laugh"	"Laugh"
"dota_chatwheel_message_naga_siren_thank"	"ช่างไปได้สวย"
"[english]dota_chatwheel_message_naga_siren_thank"	"That went swimmingly."
"dota_chatwheel_label_naga_siren_thank"	"ช่างไปได้สวย"
"[english]dota_chatwheel_label_naga_siren_thank"	"That went swimmingly."
"dota_chatwheel_message_naga_siren_deny"	"โชคร้ายนะ"
"[english]dota_chatwheel_message_naga_siren_deny"	"A sour note."
"dota_chatwheel_label_naga_siren_deny"	"โชคร้ายนะ"
"[english]dota_chatwheel_label_naga_siren_deny"	"A sour note."
"dota_chatwheel_message_naga_siren_1"	"เจ้ารุกล้ำเข้ามาลึกไปแล้วนะ"
"[english]dota_chatwheel_message_naga_siren_1"	"You're in deep now."
"dota_chatwheel_label_naga_siren_1"	"เจ้ารุกล้ำเข้ามาลึกไปแล้วนะ"
"[english]dota_chatwheel_label_naga_siren_1"	"You're in deep now."
"dota_chatwheel_message_naga_siren_2"	"พอแค่นั้นแหละ"
"[english]dota_chatwheel_message_naga_siren_2"	"That's enough out of you."
"dota_chatwheel_label_naga_siren_2"	"พอแค่นั้นแหละ"
"[english]dota_chatwheel_label_naga_siren_2"	"That's enough out of you."
"dota_chatwheel_message_naga_siren_3"	"มันต้องแย่แน่ ๆ เลย"
"[english]dota_chatwheel_message_naga_siren_3"	"That's got to suck."
"dota_chatwheel_label_naga_siren_3"	"มันต้องแย่แน่ ๆ เลย"
"[english]dota_chatwheel_label_naga_siren_3"	"That's got to suck."
"dota_chatwheel_message_naga_siren_4"	"มันต้องได้สิ"
"[english]dota_chatwheel_message_naga_siren_4"	"It had to be."
"dota_chatwheel_label_naga_siren_4"	"มันต้องได้สิ"
"[english]dota_chatwheel_label_naga_siren_4"	"It had to be."
"dota_chatwheel_message_naga_siren_5"	"ขาข้า! ขาข้าไม่มีความรู้สึก"
"[english]dota_chatwheel_message_naga_siren_5"	"My legs! I can't feel my legs."
"dota_chatwheel_label_naga_siren_5"	"ขาข้า!"
"[english]dota_chatwheel_label_naga_siren_5"	"My legs!"
"dota_chatwheel_message_keeper_of_the_light_laugh"	"ฮี้ ฮื่อ ฮื่อ ฮื่อ ฮื่อ ฮื่อ"
"[english]dota_chatwheel_message_keeper_of_the_light_laugh"	"Eh hee hee hee hee hee."
"dota_chatwheel_label_keeper_of_the_light_laugh"	"หัวเราะ"
"[english]dota_chatwheel_label_keeper_of_the_light_laugh"	"Laugh"
"dota_chatwheel_message_keeper_of_the_light_thank"	"ขอให้แสงสว่างนำทางเจ้า"
"[english]dota_chatwheel_message_keeper_of_the_light_thank"	"May the light keep you."
"dota_chatwheel_label_keeper_of_the_light_thank"	"ขอให้แสงสว่างนำทางเจ้า"
"[english]dota_chatwheel_label_keeper_of_the_light_thank"	"May the light keep you."
"dota_chatwheel_message_keeper_of_the_light_deny"	"มานาหมด"
"[english]dota_chatwheel_message_keeper_of_the_light_deny"	"No mana."
"dota_chatwheel_label_keeper_of_the_light_deny"	"มานาหมด!"
"[english]dota_chatwheel_label_keeper_of_the_light_deny"	"No mana!"
"dota_chatwheel_message_wisp_laugh"	"บีปหัวเราะ"
"[english]dota_chatwheel_message_wisp_laugh"	"Laughing Beeps"
"dota_chatwheel_label_wisp_laugh"	"บีปหัวเราะ"
"[english]dota_chatwheel_label_wisp_laugh"	"Laughing Beeps"
"dota_chatwheel_message_wisp_thank"	"บีปขอบคุณ"
"[english]dota_chatwheel_message_wisp_thank"	"Thankful Beeps"
"dota_chatwheel_label_wisp_thank"	"บีปขอบคุณ"
"[english]dota_chatwheel_label_wisp_thank"	"Thankful Beeps"
"dota_chatwheel_message_wisp_deny"	"บีปปฏิเสธ"
"[english]dota_chatwheel_message_wisp_deny"	"Denying Beeps"
"dota_chatwheel_label_wisp_deny"	"บีปปฏิเสธ"
"[english]dota_chatwheel_label_wisp_deny"	"Denying Beeps"
"dota_chatwheel_message_wisp_1"	"บีปเป็นมิตร"
"[english]dota_chatwheel_message_wisp_1"	"Friendly Beeps"
"dota_chatwheel_label_wisp_1"	"บีปเป็นมิตร"
"[english]dota_chatwheel_label_wisp_1"	"Friendly Beeps"
"dota_chatwheel_message_wisp_2"	"บีปฉลองชัยชนะ"
"[english]dota_chatwheel_message_wisp_2"	"Triumphant Beeps"
"dota_chatwheel_label_wisp_2"	"บีปฉลองชัยชนะ"
"[english]dota_chatwheel_label_wisp_2"	"Triumphant Beeps"
"dota_chatwheel_message_wisp_3"	"บีปเสียใจ"
"[english]dota_chatwheel_message_wisp_3"	"Sorrowful Beeps"
"dota_chatwheel_label_wisp_3"	"บีปเสียใจ"
"[english]dota_chatwheel_label_wisp_3"	"Sorrowful Beeps"
"dota_chatwheel_message_wisp_4"	"บีปโมโห"
"[english]dota_chatwheel_message_wisp_4"	"Angry Beeps"
"dota_chatwheel_label_wisp_4"	"บีปโมโห"
"[english]dota_chatwheel_label_wisp_4"	"Angry Beeps"
"dota_chatwheel_message_wisp_5"	"บีปครุ่นคิด"
"[english]dota_chatwheel_message_wisp_5"	"Meditative Beeps"
"dota_chatwheel_label_wisp_5"	"บีปครุ่นคิด"
"[english]dota_chatwheel_label_wisp_5"	"Meditative Beeps"
"dota_chatwheel_message_visage_laugh"	"ฮ้า ฮ่า ฮ่า ฮ่า ฮ่า ฮ่า ฮ่า ฮ่า ฮ่า!"
"[english]dota_chatwheel_message_visage_laugh"	"Ah ha ha ha ha ha ha ha ha!"
"dota_chatwheel_label_visage_laugh"	"หัวเราะ"
"[english]dota_chatwheel_label_visage_laugh"	"Laugh"
"dota_chatwheel_message_visage_thank"	"Visage ชอบ"
"[english]dota_chatwheel_message_visage_thank"	"Visage like."
"dota_chatwheel_label_visage_thank"	"Visage ชอบ"
"[english]dota_chatwheel_label_visage_thank"	"Visage like."
"dota_chatwheel_message_visage_deny"	"เจ้าอีกแล้วรึ?"
"[english]dota_chatwheel_message_visage_deny"	"You again?"
"dota_chatwheel_label_visage_deny"	"เจ้าอีกแล้วรึ?"
"[english]dota_chatwheel_label_visage_deny"	"You again?"
"dota_chatwheel_message_visage_1"	"แล้วเจ้าก็ตาย"
"[english]dota_chatwheel_message_visage_1"	"And so you die."
"dota_chatwheel_label_visage_1"	"แล้วเจ้าก็ตาย"
"[english]dota_chatwheel_label_visage_1"	"And so you die."
"dota_chatwheel_message_visage_2"	"ข้าทำพลาด"
"[english]dota_chatwheel_message_visage_2"	"I have failed."
"dota_chatwheel_label_visage_2"	"ข้าทำพลาด"
"[english]dota_chatwheel_label_visage_2"	"I have failed."
"dota_chatwheel_message_visage_3"	"ข้ามศพข้าไปก่อน!"
"[english]dota_chatwheel_message_visage_3"	"You shall not pass!"
"dota_chatwheel_label_visage_3"	"ข้ามศพข้าไปก่อน!"
"[english]dota_chatwheel_label_visage_3"	"You shall not pass!"
"dota_chatwheel_message_visage_4"	"โฉมหน้าแห่งความตาย"
"[english]dota_chatwheel_message_visage_4"	"Face of death."
"dota_chatwheel_message_visage_5"	"อ้าาา ดีขึ้นเยอะเลย"
"[english]dota_chatwheel_message_visage_5"	"Ahh this is much better."
"dota_chatwheel_label_visage_5"	"ดีขึ้นเยอะเลย"
"[english]dota_chatwheel_label_visage_5"	"Much better"
"dota_chatwheel_message_slark_laugh"	"ฮื่อ ฮื่อ ฮื่อ ฮื่อ ฮื่อ ฮื่อ ฮื่อ ฮื่อ"
"[english]dota_chatwheel_message_slark_laugh"	"Heh heh heh heh heh heh heh heh."
"dota_chatwheel_label_slark_laugh"	"หัวเราะ"
"[english]dota_chatwheel_label_slark_laugh"	"Laugh"
"dota_chatwheel_message_slark_deny"	"ล้มลงและคลานซะ"
"[english]dota_chatwheel_message_slark_deny"	"On your belly and crawl."
"dota_chatwheel_label_slark_deny"	"ล้มลง"
"[english]dota_chatwheel_label_slark_deny"	"On your belly"
"dota_chatwheel_message_slark_1"	"ว่าไงนะไม่ได้ยิน"
"[english]dota_chatwheel_message_slark_1"	"I can't hear you."
"dota_chatwheel_label_slark_1"	"ว่าไงนะไม่ได้ยิน"
"[english]dota_chatwheel_label_slark_1"	"I can't hear you."
"dota_chatwheel_message_medusa_laugh"	"ฮื้มม ฮื้มม ฮื้มม ฮ่า ฮ่า ฮ่า ฮ่า ฮ่า!"
"[english]dota_chatwheel_message_medusa_laugh"	"Hmm hmm hmm ha ha ha ha ha!"
"dota_chatwheel_label_medusa_laugh"	"หัวเราะ"
"[english]dota_chatwheel_label_medusa_laugh"	"Laugh"
"dota_chatwheel_message_medusa_thank"	"แพรวพราว"
"[english]dota_chatwheel_message_medusa_thank"	"Brilliant."
"dota_chatwheel_label_medusa_thank"	"แพรวพราว"
"[english]dota_chatwheel_label_medusa_thank"	"Brilliant."
"dota_chatwheel_message_medusa_deny"	"สมน้ำหน้า"
"[english]dota_chatwheel_message_medusa_deny"	"In your face."
"dota_chatwheel_label_medusa_deny"	"สมน้ำหน้า"
"[english]dota_chatwheel_label_medusa_deny"	"In your face."
"dota_chatwheel_message_medusa_1"	"อย่าได้ริอาจขัดขืนงูเห่า เจ้านกน้อย"
"[english]dota_chatwheel_message_medusa_1"	"Don't resist the cobra, little bird."
"dota_chatwheel_label_medusa_1"	"อย่าได้ริอาจขัดขืนงูเห่า"
"[english]dota_chatwheel_label_medusa_1"	"Don't resist the cobra"
"dota_chatwheel_message_medusa_2"	"โอ้ แย่จัง!"
"[english]dota_chatwheel_message_medusa_2"	"Oh, crap!"
"dota_chatwheel_label_medusa_2"	"โอ้ แย่จัง"
"[english]dota_chatwheel_label_medusa_2"	"Oh, crap."
"dota_chatwheel_message_medusa_3"	"เจ้าก็รู้ว่าข้าเลือดเย็น"
"[english]dota_chatwheel_message_medusa_3"	"You knew I was cold-blooded."
"dota_chatwheel_label_medusa_3"	"เจ้าก็รู้ว่าข้าเลือดเย็น"
"[english]dota_chatwheel_label_medusa_3"	"You knew I was cold-blooded."
"dota_chatwheel_message_medusa_4"	"จ้องมองความสวยของ Medusa และจงสิ้นหวัง!"
"[english]dota_chatwheel_message_medusa_4"	"Gaze upon Medusa's beauty, and despair!"
"dota_chatwheel_label_medusa_4"	"จ้องมองความสวยของ Medusa..."
"[english]dota_chatwheel_label_medusa_4"	"Gaze upon Medusa's beauty..."
"dota_chatwheel_message_troll_warlord_laugh"	"ย้าาาฮ่าฮ่าฮ่าฮ้าฮ่าา"
"[english]dota_chatwheel_message_troll_warlord_laugh"	"Yaaahahahaahhah."
"dota_chatwheel_label_troll_warlord_laugh"	"หัวเราะ"
"[english]dota_chatwheel_label_troll_warlord_laugh"	"Laugh"
"dota_chatwheel_message_troll_warlord_thank"	"บ้าไปแล้ว!"
"[english]dota_chatwheel_message_troll_warlord_thank"	"Go crazy!"
"dota_chatwheel_label_troll_warlord_thank"	"บ้าไปแล้ว!"
"[english]dota_chatwheel_label_troll_warlord_thank"	"Go crazy!"
"dota_chatwheel_message_troll_warlord_deny"	"โชคไม่ค่อยดีนะ"
"[english]dota_chatwheel_message_troll_warlord_deny"	"Unfortunate."
"dota_chatwheel_label_troll_warlord_deny"	"โชคไม่ค่อยดีนะ"
"[english]dota_chatwheel_label_troll_warlord_deny"	"Unfortunate."
"dota_chatwheel_message_troll_warlord_1"	"กลับมาตายอีกนะ"
"[english]dota_chatwheel_message_troll_warlord_1"	"Come back and die again."
"dota_chatwheel_label_troll_warlord_1"	"กลับมา..."
"[english]dota_chatwheel_label_troll_warlord_1"	"Come back..."
"dota_chatwheel_message_centaur_laugh"	"ฮี่ฮื่ออฮื้อ ฮ่าฮ่าา ฮ้าฮ่า"
"[english]dota_chatwheel_message_centaur_laugh"	"Heheeeh hahah ehha."
"dota_chatwheel_label_centaur_laugh"	"หัวเราะ"
"[english]dota_chatwheel_label_centaur_laugh"	"Laugh"
"dota_chatwheel_message_centaur_deny"	"กระทืบ"
"[english]dota_chatwheel_message_centaur_deny"	"Stomped."
"dota_chatwheel_label_centaur_deny"	"กระทืบ"
"[english]dota_chatwheel_label_centaur_deny"	"Stomped."
"dota_chatwheel_message_centaur_1"	"อืมมมม"
"[english]dota_chatwheel_message_centaur_1"	"Mmmmm."
"dota_chatwheel_label_centaur_1"	"อืมมมมม"
"[english]dota_chatwheel_label_centaur_1"	"Mmmmmm."
"dota_chatwheel_message_centaur_2"	"เสียของหมด"
"[english]dota_chatwheel_message_centaur_2"	"What a waste."
"dota_chatwheel_label_centaur_2"	"เสียของหมด"
"[english]dota_chatwheel_label_centaur_2"	"What a waste."
"dota_chatwheel_message_centaur_3"	"กลับนรกไปซะ"
"[english]dota_chatwheel_message_centaur_3"	"Back to hell with you."
"dota_chatwheel_label_centaur_3"	"กลับนรกไปซะ"
"[english]dota_chatwheel_label_centaur_3"	"Back to hell with you."
"dota_chatwheel_message_magnataur_laugh"	"ฮ้า ฮ่า ฮ่า"
"[english]dota_chatwheel_message_magnataur_laugh"	"Ah ha ha."
"dota_chatwheel_label_magnataur_laugh"	"หัวเราะ"
"[english]dota_chatwheel_label_magnataur_laugh"	"Laugh"
"dota_chatwheel_message_magnataur_4"	"น่าอับอายเสียจริง"
"[english]dota_chatwheel_message_magnataur_4"	"How shameful."
"dota_chatwheel_label_magnataur_4"	"น่าอับอายเสียจริง"
"[english]dota_chatwheel_label_magnataur_4"	"How shameful."
"dota_chatwheel_message_shredder_laugh"	"ฮี่ ฮี่ ฮี่ ฮี่ ฮี่!"
"[english]dota_chatwheel_message_shredder_laugh"	"He he he he he!"
"dota_chatwheel_label_shredder_laugh"	"หัวเราะ"
"[english]dota_chatwheel_label_shredder_laugh"	"Laugh"
"dota_chatwheel_message_shredder_5"	"วิ่ง วิ่ง วิ่ง วิ่ง วิ่งวิ่งวิ่งวิ่งวิ่งวิ่งวิ่งวิ่งวิ่งวิ่งวิ่งวิ่งวิ่งวิ่งวิ่งวิ่งวิ่งวิ่งไป!"
"[english]dota_chatwheel_message_shredder_5"	"Run run run run runrunrunrunrunrunrunrunrunrunrunrunrunrunrunrunrunrun!"
"dota_chatwheel_label_shredder_5"	"วิ่ง วิ่ง วิ่งวิ่ง วิ่งวิ่งวิ่ง!"
"[english]dota_chatwheel_label_shredder_5"	"Run run runrun runrunrun!"
"dota_chatwheel_message_bristleback_laugh"	"ฮี่เฮ้ ฮ่าฮ่าฮ่า"
"[english]dota_chatwheel_message_bristleback_laugh"	"Hehey hahaha."
"dota_chatwheel_label_bristleback_laugh"	"หัวเราะ"
"[english]dota_chatwheel_label_bristleback_laugh"	"Laugh"
"dota_chatwheel_message_bristleback_2"	"ไม่มีทาง"
"[english]dota_chatwheel_message_bristleback_2"	"No way."
"dota_chatwheel_label_bristleback_2"	"ไม่มีทาง"
"[english]dota_chatwheel_label_bristleback_2"	"No way."
"dota_chatwheel_message_tusk_laugh"	"โอ้เจ้าหนู! ฮ่า ฮ่า ฮ่า ฮ่า ฮ่า!"
"[english]dota_chatwheel_message_tusk_laugh"	"Oh boy! Ha ha ha ha ha!"
"dota_chatwheel_label_tusk_laugh"	"หัวเราะ"
"[english]dota_chatwheel_label_tusk_laugh"	"Laugh"
"dota_chatwheel_message_tusk_deny"	"ข้าก็ทำเต็มที่แล้วนะ"
"[english]dota_chatwheel_message_tusk_deny"	"Well I tried."
"dota_chatwheel_label_tusk_deny"	"ข้าก็ทำเต็มที่แล้วนะ"
"[english]dota_chatwheel_label_tusk_deny"	"Well I tried."
"dota_chatwheel_message_tusk_1"	"สบายดีหรือเปล่า?"
"[english]dota_chatwheel_message_tusk_1"	"Are you okay?"
"dota_chatwheel_label_tusk_1"	"เจ้าโอเคนะ?"
"[english]dota_chatwheel_label_tusk_1"	"Are you ok?"
"dota_chatwheel_message_skywrath_mage_laugh"	"ฮ่า ฮ่า!"
"[english]dota_chatwheel_message_skywrath_mage_laugh"	"Ha ha!"
"dota_chatwheel_label_skywrath_mage_laugh"	"หัวเราะ"
"[english]dota_chatwheel_label_skywrath_mage_laugh"	"Laugh"
"dota_chatwheel_message_skywrath_mage_thank"	"ข้าจะไม่รายงานเจ้า"
"[english]dota_chatwheel_message_skywrath_mage_thank"	"I shall not report you."
"dota_chatwheel_label_skywrath_mage_thank"	"ข้าจะไม่รายงานเจ้า"
"[english]dota_chatwheel_label_skywrath_mage_thank"	"I shall not report you."
"dota_chatwheel_message_skywrath_mage_5"	"เสมือนท้องฟ้าวิปริตแปรปรวนทันใดด้วยพลัง Skywrath!"
"[english]dota_chatwheel_message_skywrath_mage_5"	"The skies are dark with Skywrath power!"
"dota_chatwheel_label_skywrath_mage_5"	"เสมือนท้องฟ้าวิปริตแปรปรวนทันใดด้วยพลัง Skywrath!"
"[english]dota_chatwheel_label_skywrath_mage_5"	"The skies are dark with Skywrath power!"
"dota_chatwheel_message_abaddon_laugh"	"ฮ่า ฮ่า ฮ่า ฮ่า ฮ่า ฮ่า ฮ่า ฮ่า ฮ่า"
"[english]dota_chatwheel_message_abaddon_laugh"	"Ha ha ha ha ha ha ha ha ha."
"dota_chatwheel_label_abaddon_laugh"	"หัวเราะ"
"[english]dota_chatwheel_label_abaddon_laugh"	"Laugh"
"dota_chatwheel_message_abaddon_deny"	"ไม่มีทาง"
"[english]dota_chatwheel_message_abaddon_deny"	"Never."
"dota_chatwheel_label_abaddon_deny"	"ไม่มีทาง"
"[english]dota_chatwheel_label_abaddon_deny"	"Never."
"dota_chatwheel_message_elder_titan_laugh"	"ฮี้ ฮ่า ฮ่า ฮ่า ฮ่า ฮ่า"
"[english]dota_chatwheel_message_elder_titan_laugh"	"Eh ha ha ha ha ha."
"dota_chatwheel_label_elder_titan_laugh"	"หัวเราะ"
"[english]dota_chatwheel_label_elder_titan_laugh"	"Laugh"
"dota_chatwheel_message_legion_commander_laugh"	"ฮ้า ฮ่า ฮ่า ฮ่า ฮ่า ฮ่า ฮ่า!"
"[english]dota_chatwheel_message_legion_commander_laugh"	"Ah ha ha ha ha ha ha!"
"dota_chatwheel_label_legion_commander_laugh"	"หัวเราะ"
"[english]dota_chatwheel_label_legion_commander_laugh"	"Laugh"
"dota_chatwheel_message_legion_commander_thank"	"ไม่เลวเลยนะ!"
"[english]dota_chatwheel_message_legion_commander_thank"	"Not bad at all!"
"dota_chatwheel_label_legion_commander_thank"	"ไม่เลวเลยนะ!"
"[english]dota_chatwheel_label_legion_commander_thank"	"Not bad at all!"
"dota_chatwheel_message_legion_commander_deny"	"พยายามขึ้นอีกหน่อยนะ"
"[english]dota_chatwheel_message_legion_commander_deny"	"Try harder."
"dota_chatwheel_label_legion_commander_deny"	"พยายามขึ้นอีกหน่อยนะ"
"[english]dota_chatwheel_label_legion_commander_deny"	"Try Harder."
"dota_chatwheel_message_legion_commander_4"	"ไอ้ลูกกะ...!"
"[english]dota_chatwheel_message_legion_commander_4"	"Son of a...!"
"dota_chatwheel_label_legion_commander_4"	"ไอ้ลูกกะ..."
"[english]dota_chatwheel_label_legion_commander_4"	"Son of a..."
"dota_chatwheel_message_techies_laugh"	"ฮี่ ฮี่ ฮี่, ฮี่ฮี่ ฮ้า ฮ่า! โฮ่ โฮ้ โฮ้ โฮ่ โฮ่ ฮ่า ฮ่า ฮ่า!"
"[english]dota_chatwheel_message_techies_laugh"	"He he he, hehe ah ha! Oh ho ho oh oh ha ha ha!"
"dota_chatwheel_label_techies_laugh"	"หัวเราะ"
"[english]dota_chatwheel_label_techies_laugh"	"Laugh"
"dota_chatwheel_message_techies_thank"	"สนุกจัง! ฮู้ฮู้ฮู้!"
"[english]dota_chatwheel_message_techies_thank"	"Fun! Huhuhu!"
"dota_chatwheel_label_techies_thank"	"สนุกจัง!"
"[english]dota_chatwheel_label_techies_thank"	"Fun!"
"dota_chatwheel_message_techies_deny"	"ไหงมีคนบอกฉันว่ามันจะระเบิดเป็นเมฆรูปเห็ดอะ!"
"[english]dota_chatwheel_message_techies_deny"	"I was told there'd be a mushroom cloud!"
"dota_chatwheel_label_techies_deny"	"ระเบิดเป็นเมฆรูปเห็ด"
"[english]dota_chatwheel_label_techies_deny"	"Mushroom cloud."
"dota_chatwheel_message_techies_1"	"โอ้ ซวยละ!"
"[english]dota_chatwheel_message_techies_1"	"Oh crap!"
"dota_chatwheel_label_techies_1"	"โอ้ ซวยละ!"
"[english]dota_chatwheel_label_techies_1"	"Oh crap!"
"dota_chatwheel_message_techies_2"	"หายไปไหนแล้ว? ระเบิดกระจายไปทุกที่แล้วไง!"
"[english]dota_chatwheel_message_techies_2"	"Where'd he go? Everywhere!"
"dota_chatwheel_label_techies_2"	"หายไปไหนแล้ว? ระเบิดกระจายไปทุกที่แล้วไง!"
"[english]dota_chatwheel_label_techies_2"	"Where'd he go? Everywhere!"
"dota_chatwheel_message_techies_3"	"เสร็จฉันล่ะ!"
"[english]dota_chatwheel_message_techies_3"	"Gotcha!"
"dota_chatwheel_label_techies_3"	"เสร็จฉันล่ะ!"
"[english]dota_chatwheel_label_techies_3"	"Gotcha!"
"dota_chatwheel_message_techies_4"	"เชิญแกนั่งรอตรงนั้นก่อน ปล่อยให้คนฉลาดเขาทำงานกัน"
"[english]dota_chatwheel_message_techies_4"	"Just have a seat right over there. And let the smart people work."
"dota_chatwheel_label_techies_4"	"เชิญแกนั่ง"
"[english]dota_chatwheel_label_techies_4"	"Have a seat."
"dota_chatwheel_message_techies_5"	"ไม่อยากเชื่อว่ามันได้ผล"
"[english]dota_chatwheel_message_techies_5"	"I can't believe that worked."
"dota_chatwheel_label_techies_5"	"ไม่อยากเชื่อว่ามันได้ผล"
"[english]dota_chatwheel_label_techies_5"	"I can't believe that worked."
"dota_chatwheel_message_ember_spirit_laugh"	"ฮี้ ฮี่ ฮี่ ฮี่ ฮี่ ฮี่!"
"[english]dota_chatwheel_message_ember_spirit_laugh"	"Eh he he he he he!"
"dota_chatwheel_label_ember_spirit_laugh"	"หัวเราะ"
"[english]dota_chatwheel_label_ember_spirit_laugh"	"Laugh"
"dota_chatwheel_message_ember_spirit_3"	"ความสมดุลอยู่ในทุกสรรพสิ่ง"
"[english]dota_chatwheel_message_ember_spirit_3"	"Balance in all things."
"dota_chatwheel_label_ember_spirit_3"	"ความสมดุลอยู่ในทุกสรรพสิ่ง"
"[english]dota_chatwheel_label_ember_spirit_3"	"Balance in all things."
"dota_chatwheel_message_earth_spirit_laugh"	"โอ้ โฮ้ โฮ้ ฮ่า ฮ่า ฮ่า ฮ่า ฮ่า ฮ่า!"
"[english]dota_chatwheel_message_earth_spirit_laugh"	"Oh ho ho ha ha ha ha ha ha!"
"dota_chatwheel_label_earth_spirit_laugh"	"หัวเราะ"
"[english]dota_chatwheel_label_earth_spirit_laugh"	"Laugh"
"dota_chatwheel_message_earth_spirit_1"	"อะไร?"
"[english]dota_chatwheel_message_earth_spirit_1"	"What?"
"dota_chatwheel_label_earth_spirit_1"	"อะไร?"
"[english]dota_chatwheel_label_earth_spirit_1"	"What?"
"dota_chatwheel_message_earth_spirit_4"	"จริงดิ? จริงดิ?"
"[english]dota_chatwheel_message_earth_spirit_4"	"Really? Really?"
"dota_chatwheel_label_earth_spirit_4"	"จริงดิ? จริงดิ?"
"[english]dota_chatwheel_label_earth_spirit_4"	"Really? Really?"
"dota_chatwheel_message_abyssal_underlord_laugh"	"ฮ้า ฮ่า ฮ่า ฮ่า ฮ่า ฮ่า ฮ่า ฮ่า ฮ่า!"
"[english]dota_chatwheel_message_abyssal_underlord_laugh"	"Ah ha ha ha ha ha ha ha ha!"
"dota_chatwheel_label_abyssal_underlord_laugh"	"หัวเราะ"
"[english]dota_chatwheel_label_abyssal_underlord_laugh"	"Laugh"
"dota_chatwheel_message_abyssal_underlord_thank"	"ข้าไม่ขอบคุณ"
"[english]dota_chatwheel_message_abyssal_underlord_thank"	"I do not thank."
"dota_chatwheel_label_abyssal_underlord_thank"	"ข้าไม่ขอบคุณ"
"[english]dota_chatwheel_label_abyssal_underlord_thank"	"I do not thank."
"dota_chatwheel_message_abyssal_underlord_deny"	"อัปรีย์!"
"[english]dota_chatwheel_message_abyssal_underlord_deny"	"Curses!"
"dota_chatwheel_label_abyssal_underlord_deny"	"อัปรีย์!"
"[english]dota_chatwheel_label_abyssal_underlord_deny"	"Curses!"
"dota_chatwheel_message_abyssal_underlord_1"	"โอ้ ใช่"
"[english]dota_chatwheel_message_abyssal_underlord_1"	"Oh yes."
"dota_chatwheel_label_abyssal_underlord_1"	"โอ้ ใช่"
"[english]dota_chatwheel_label_abyssal_underlord_1"	"Oh yes."
"dota_chatwheel_message_abyssal_underlord_2"	"พวกไร้ค่า!"
"[english]dota_chatwheel_message_abyssal_underlord_2"	"Insignificant."
"dota_chatwheel_label_abyssal_underlord_2"	"พวกไร้ค่า!"
"[english]dota_chatwheel_label_abyssal_underlord_2"	"Insignificant!"
"dota_chatwheel_message_abyssal_underlord_3"	"จงกราบนายใหม่ของเจ้า"
"[english]dota_chatwheel_message_abyssal_underlord_3"	"Bow to your new lord."
"dota_chatwheel_label_abyssal_underlord_3"	"จงกราบนายใหม่ของเจ้า"
"[english]dota_chatwheel_label_abyssal_underlord_3"	"Bow to your new lord."
"dota_chatwheel_message_abyssal_underlord_4"	"สิ้นหวังแล้ว"
"[english]dota_chatwheel_message_abyssal_underlord_4"	"There is no hope."
"dota_chatwheel_label_abyssal_underlord_4"	"สิ้นหวังแล้ว"
"[english]dota_chatwheel_label_abyssal_underlord_4"	"There is no hope."
"dota_chatwheel_message_abyssal_underlord_5"	"เกาะแน่น ๆ นะน้องนะ"
"[english]dota_chatwheel_message_abyssal_underlord_5"	"Hold on to your butts."
"dota_chatwheel_label_abyssal_underlord_5"	"เกาะแน่น ๆ!"
"[english]dota_chatwheel_label_abyssal_underlord_5"	"Hold on!"
"dota_chatwheel_message_terrorblade_laugh"	"ฮือฮะฮ่ะฮ่าฮ่าาา"
"[english]dota_chatwheel_message_terrorblade_laugh"	"Hehahahahahh."
"dota_chatwheel_label_terrorblade_laugh"	"หัวเราะ"
"[english]dota_chatwheel_label_terrorblade_laugh"	"Laugh"
"dota_chatwheel_message_terrorblade_thank"	"เป็นมารที่ช่างงดงามเสียจริง"
"[english]dota_chatwheel_message_terrorblade_thank"	"What a handsome devil."
"dota_chatwheel_label_terrorblade_thank"	"เป็นมารที่ช่างงดงามเสียจริง"
"[english]dota_chatwheel_label_terrorblade_thank"	"What a handsome devil."
"dota_chatwheel_message_terrorblade_deny"	"โอ้ พวกมันคงจะเกลียดข้าเพราะเรื่องนี้"
"[english]dota_chatwheel_message_terrorblade_deny"	"Oh, they're gonna hate me for this."
"dota_chatwheel_label_terrorblade_deny"	"พวกมันคงจะเกลียดข้าเพราะเรื่องนี้"
"[english]dota_chatwheel_label_terrorblade_deny"	"They're gonna hate me for this."
"dota_chatwheel_message_terrorblade_1"	"อุบายแลกอย่างแยบยล"
"[english]dota_chatwheel_message_terrorblade_1"	"Trick of the trade."
"dota_chatwheel_label_terrorblade_1"	"อุบายแลกอย่างแยบยล"
"[english]dota_chatwheel_label_terrorblade_1"	"Trick of the trade."
"dota_chatwheel_message_terrorblade_2"	"ศัตรูอันเลวร้ายคือตัวเจ้าเอง"
"[english]dota_chatwheel_message_terrorblade_2"	"Your own worst enemy."
"dota_chatwheel_label_terrorblade_2"	"ศัตรูอันเลวร้ายคือตัวเจ้าเอง"
"[english]dota_chatwheel_label_terrorblade_2"	"Your own worst enemy."
"dota_chatwheel_message_terrorblade_3"	"นั่นคงมิใช่ความชาญฉลาดกระมัง"
"[english]dota_chatwheel_message_terrorblade_3"	"Perhaps that wasn't wise."
"dota_chatwheel_label_terrorblade_3"	"นั่นคงมิใช่ความชาญฉลาดกระมัง"
"[english]dota_chatwheel_label_terrorblade_3"	"Perhaps that wasn't wise."
"dota_chatwheel_message_terrorblade_4"	"คมมีดอันชาญฉลาดจักพรากชีวิตผู้โง่เขลา"
"[english]dota_chatwheel_message_terrorblade_4"	"A wise blade takes a fool's life."
"dota_chatwheel_label_terrorblade_4"	"คมมีดอันชาญฉลาด"
"[english]dota_chatwheel_label_terrorblade_4"	"Wise blade."
"dota_chatwheel_message_terrorblade_5"	"จงต่อกรกับข้า เจ้าขี้ขลาด!"
"[english]dota_chatwheel_message_terrorblade_5"	"Fight me, cowards!"
"dota_chatwheel_label_terrorblade_5"	"จงต่อกรกับข้า!"
"[english]dota_chatwheel_label_terrorblade_5"	"Fight me!"
"dota_chatwheel_message_phoenix_laugh"	"ขันหัวเราะ"
"[english]dota_chatwheel_message_phoenix_laugh"	"Laughing Squawk"
"dota_chatwheel_label_phoenix_laugh"	"ขันหัวเราะ"
"[english]dota_chatwheel_label_phoenix_laugh"	"Laughing Squawk"
"dota_chatwheel_message_phoenix_thank"	"ขันขอบคุณ"
"[english]dota_chatwheel_message_phoenix_thank"	"Thankful Squawk"
"dota_chatwheel_label_phoenix_thank"	"ขันขอบคุณ"
"[english]dota_chatwheel_label_phoenix_thank"	"Thankful Squawk"
"dota_chatwheel_message_phoenix_deny"	"ขันปฏิเสธ"
"[english]dota_chatwheel_message_phoenix_deny"	"Denying Squawk"
"dota_chatwheel_label_phoenix_deny"	"ขันปฏิเสธ"
"[english]dota_chatwheel_label_phoenix_deny"	"Denying Squawk"
"dota_chatwheel_message_phoenix_1"	"ขันฉลองชัยชนะ"
"[english]dota_chatwheel_message_phoenix_1"	"Triumphant Squawk"
"dota_chatwheel_label_phoenix_1"	"ขันฉลองชัยชนะ"
"[english]dota_chatwheel_label_phoenix_1"	"Triumphant Squawk"
"dota_chatwheel_message_phoenix_2"	"ขันเสียใจ"
"[english]dota_chatwheel_message_phoenix_2"	"Sorrowful Squawk"
"dota_chatwheel_label_phoenix_2"	"ขันเสียใจ"
"[english]dota_chatwheel_label_phoenix_2"	"Sorrowful Squawk"
"dota_chatwheel_message_phoenix_3"	"ขันเยาะเย้ย"
"[english]dota_chatwheel_message_phoenix_3"	"Taunting Squawk"
"dota_chatwheel_label_phoenix_3"	"ขันเยาะเย้ย"
"[english]dota_chatwheel_label_phoenix_3"	"Taunting Squawk"
"dota_chatwheel_message_phoenix_4"	"ขันโมโห"
"[english]dota_chatwheel_message_phoenix_4"	"Angry Squawk"
"dota_chatwheel_label_phoenix_4"	"ขันโมโห"
"[english]dota_chatwheel_label_phoenix_4"	"Angry Squawk"
"dota_chatwheel_message_phoenix_5"	"ขันพอใจ"
"[english]dota_chatwheel_message_phoenix_5"	"Contented Squawk"
"dota_chatwheel_label_phoenix_5"	"ขันพอใจ"
"[english]dota_chatwheel_label_phoenix_5"	"Contented Squawk"
"dota_chatwheel_message_oracle_laugh"	"ฮี่ ฮ่า ฮ่า ฮี่ ฮ่า ฮ่า!"
"[english]dota_chatwheel_message_oracle_laugh"	"He ha ha he ha ha!"
"dota_chatwheel_label_oracle_laugh"	"หัวเราะ"
"[english]dota_chatwheel_label_oracle_laugh"	"Laugh"
"dota_chatwheel_message_oracle_deny"	"ข้าอยากตาย"
"[english]dota_chatwheel_message_oracle_deny"	"I want to die."
"dota_chatwheel_label_oracle_deny"	"ข้าอยากตาย"
"[english]dota_chatwheel_label_oracle_deny"	"I want to die."
"dota_chatwheel_message_oracle_1"	"ข้าเห็นนะ"
"[english]dota_chatwheel_message_oracle_1"	"I saw that."
"dota_chatwheel_label_oracle_1"	"ข้าเห็นนะ"
"[english]dota_chatwheel_label_oracle_1"	"I saw that."
"dota_chatwheel_message_oracle_2"	"ข้าผวาเลยรู้ไหม ผวามาก!"
"[english]dota_chatwheel_message_oracle_2"	"I am shocked. Shocked!"
"dota_chatwheel_label_oracle_2"	"ข้าผวา"
"[english]dota_chatwheel_label_oracle_2"	"I am shocked."
"dota_chatwheel_message_arc_warden_laugh"	"ฮื้ม ฮื้ม ฮื้ม ฮื้ม ฮื้ม ฮื้ม ฮื้ม ฮื้ม ฮื้ม ฮื้ม ฮื้ม ฮื้ม ฮื้ม ฮื้ม ฮื้ม"
"[english]dota_chatwheel_message_arc_warden_laugh"	"Hm hm hm hm hm hm hm hm hm hm hm hm hm hm hm."
"dota_chatwheel_label_arc_warden_laugh"	"หัวเราะ"
"[english]dota_chatwheel_label_arc_warden_laugh"	"Laugh"
"dota_chatwheel_message_arc_warden_deny"	"อย่าเห็นแก่ตัว"
"[english]dota_chatwheel_message_arc_warden_deny"	"Do not be selfish."
"dota_chatwheel_label_arc_warden_deny"	"อย่าเห็นแก่ตัว"
"[english]dota_chatwheel_label_arc_warden_deny"	"Do not be selfish."
"dota_chatwheel_message_arc_warden_1"	"จับได้แล้ว"
"[english]dota_chatwheel_message_arc_warden_1"	"Busted."
"dota_chatwheel_label_arc_warden_1"	"จับได้แล้ว"
"[english]dota_chatwheel_label_arc_warden_1"	"Busted."
"dota_chatwheel_message_arc_warden_2"	"เจ้าทำอะไรลงไป?"
"[english]dota_chatwheel_message_arc_warden_2"	"What have you done?"
"dota_chatwheel_label_arc_warden_2"	"เจ้าทำอะไรลงไป?"
"[english]dota_chatwheel_label_arc_warden_2"	"What have you done?"
"dota_chatwheel_message_winter_wyvern_laugh"	"ฮ้า ฮ่า ฮ่า ฮ่า ฮ่า ฮ่า ฮ่า ฮ่า ฮ่า ฮ่า ฮ่า!"
"[english]dota_chatwheel_message_winter_wyvern_laugh"	"Ah ha ha ha ha ha ha ha ha ha ha!"
"dota_chatwheel_label_winter_wyvern_laugh"	"หัวเราะ"
"[english]dota_chatwheel_label_winter_wyvern_laugh"	"Laugh"
"dota_chatwheel_message_winter_wyvern_thank"	"วิเศษ!"
"[english]dota_chatwheel_message_winter_wyvern_thank"	"Wonderful!"
"dota_chatwheel_label_winter_wyvern_thank"	"วิเศษ"
"[english]dota_chatwheel_label_winter_wyvern_thank"	"Wonderful."
"dota_chatwheel_message_winter_wyvern_deny"	"เย็นไว้นะหนู"
"[english]dota_chatwheel_message_winter_wyvern_deny"	"Chill, baby."
"dota_chatwheel_label_winter_wyvern_deny"	"เย็นไว้นะหนู"
"[english]dota_chatwheel_label_winter_wyvern_deny"	"Chill, baby."
"dota_chatwheel_message_winter_wyvern_1"	"ไม่ฉลาดเลยนะ!"
"[english]dota_chatwheel_message_winter_wyvern_1"	"That was not wise!"
"dota_chatwheel_label_winter_wyvern_1"	"ไม่ฉลาดเลยนะ"
"[english]dota_chatwheel_label_winter_wyvern_1"	"That was not wise."
"dota_chatwheel_message_winter_wyvern_2"	"โธ่ น่าสงสาร"
"[english]dota_chatwheel_message_winter_wyvern_2"	"Poor dear."
"dota_chatwheel_label_winter_wyvern_2"	"โธ่ น่าสงสาร"
"[english]dota_chatwheel_label_winter_wyvern_2"	"Poor dear."
"dota_chatwheel_message_winter_wyvern_3"	"จงอย่าได้ถามไวเวิร์นว่าเพราะเหตุใด"
"[english]dota_chatwheel_message_winter_wyvern_3"	"Never ask a wyvern why."
"dota_chatwheel_label_winter_wyvern_3"	"จงอย่าได้ถามไวเวิร์นว่าเพราะเหตุใด"
"[english]dota_chatwheel_label_winter_wyvern_3"	"Never ask a wyvern why."
"dota_chatwheel_message_winter_wyvern_4"	"สมควรเป็นอย่างยิ่ง!"
"[english]dota_chatwheel_message_winter_wyvern_4"	"Well deserved!"
"dota_chatwheel_label_winter_wyvern_4"	"สมควรเป็นอย่างยิ่ง"
"[english]dota_chatwheel_label_winter_wyvern_4"	"Well deserved."
"dota_chatwheel_message_winter_wyvern_5"	"อาห์ ข้าไม่เคยรู้สึกดีแบบนี้มาก่อน! อะฮะฮึฮืม!"
"[english]dota_chatwheel_message_winter_wyvern_5"	"Ah, I've never felt this good! Ah ha ha ha ha!"
"dota_chatwheel_label_winter_wyvern_5"	"ไม่เคยรู้สึกดีแบบนี้มาก่อน!"
"[english]dota_chatwheel_label_winter_wyvern_5"	"Never felt this good!"
"dota_chatwheel_message_monkey_king_laugh"	"ฮ้า ฮ่า ฮ่า ฮ่า ฮ่า ฮ่า วู้ฮู่ฮู่ฮู่ โห่ววว หี้ววว"
"[english]dota_chatwheel_message_monkey_king_laugh"	"Ah ha ha ha ha ha. Woohoohoohoo. Ohhh heee."
"dota_chatwheel_label_monkey_king_laugh"	"หัวเราะ"
"[english]dota_chatwheel_label_monkey_king_laugh"	"Laugh"
"dota_chatwheel_message_monkey_king_thank"	"นี่จะต้องได้ผล"
"[english]dota_chatwheel_message_monkey_king_thank"	"This'll work."
"dota_chatwheel_label_monkey_king_thank"	"นี่จะต้องได้ผล"
"[english]dota_chatwheel_label_monkey_king_thank"	"This'll work."
"dota_chatwheel_message_monkey_king_deny"	"ข้าชักจะรู้สึกดีขึ้นมาแล้วสิ"
"[english]dota_chatwheel_message_monkey_king_deny"	"I feel better already."
"dota_chatwheel_label_monkey_king_deny"	"ข้าชักจะรู้สึกดีขึ้นมาแล้วสิ"
"[english]dota_chatwheel_label_monkey_king_deny"	"I feel better already."
"dota_chatwheel_message_monkey_king_1"	"โอ้ เดี๋ยวข้าจะไปแจกลายเซ็นหน้าทางออกนะ"
"[english]dota_chatwheel_message_monkey_king_1"	"Ohh, I'll be signing autographs out front."
"dota_chatwheel_label_monkey_king_1"	"แจกลายเซ็น"
"[english]dota_chatwheel_label_monkey_king_1"	"Signing autographs"
"dota_chatwheel_message_monkey_king_2"	"โอเค อันนั้นคิดไม่ถึงมาก่อน"
"[english]dota_chatwheel_message_monkey_king_2"	"Ok, that was unexpected."
"dota_chatwheel_label_monkey_king_2"	"โอเค อันนั้นคิดไม่ถึงมาก่อน.."
"[english]dota_chatwheel_label_monkey_king_2"	"Ok, that was unexpected.."
"dota_chatwheel_message_monkey_king_3"	"ก็ได้"
"[english]dota_chatwheel_message_monkey_king_3"	"Alright."
"dota_chatwheel_label_monkey_king_3"	"ก็ได้"
"[english]dota_chatwheel_label_monkey_king_3"	"Alright."
"dota_chatwheel_message_monkey_king_4"	"ข้าจะแกล้งทำเป็นว่านี่ไม่ได้ทำให้ข้าสนุก"
"[english]dota_chatwheel_message_monkey_king_4"	"I'll pretend I didn't enjoy this."
"dota_chatwheel_label_monkey_king_4"	"ข้าจะแกล้งทำเป็นว่านี่ไม่ได้ทำให้ข้าสนุก"
"[english]dota_chatwheel_label_monkey_king_4"	"I'll pretend I didn't enjoy this."
"dota_chatwheel_message_monkey_king_5"	"มันจบลงตั้งแต่ก่อนเริ่มแล้ว"
"[english]dota_chatwheel_message_monkey_king_5"	"This was over before it started."
"dota_chatwheel_label_monkey_king_5"	"จบลงตั้งแต่ก่อนเริ่ม"
"[english]dota_chatwheel_label_monkey_king_5"	"Over before it started."
"dota_chatwheel_message_dark_willow_laugh"	"ฮ่าฮ่าฮ่า ฮะฮ่าฮ่า ฮะฮ่าฮ่า ฮ้าฮ่าฮ่าฮ่าฮ่าฮ่าา!"
"[english]dota_chatwheel_message_dark_willow_laugh"	"Hahaha ahaha ahaha ahhahahahahaa!"
"dota_chatwheel_label_dark_willow_laugh"	"หัวเราะ"
"[english]dota_chatwheel_label_dark_willow_laugh"	"Laugh"
"dota_chatwheel_message_dark_willow_thank"	"นี่แหละคือสิ่งที่ข้ารอคอย"
"[english]dota_chatwheel_message_dark_willow_thank"	"Just what I was waiting for."
"dota_chatwheel_label_dark_willow_thank"	"นี่แหละคือสิ่งที่ข้ารอคอย"
"[english]dota_chatwheel_label_dark_willow_thank"	"Just what I was waiting for."
"dota_chatwheel_message_dark_willow_deny"	"บอกตามตรงเลยนะ ข้าก็คิดไม่ถึงมาก่อน"
"[english]dota_chatwheel_message_dark_willow_deny"	"I won't lie, that was unexpected..."
"dota_chatwheel_label_dark_willow_deny"	"คิดไม่ถึงมาก่อน"
"[english]dota_chatwheel_label_dark_willow_deny"	"That was unexpected"
"dota_chatwheel_message_dark_willow_1"	"ไม่ ก็คือ... ไม่"
"[english]dota_chatwheel_message_dark_willow_1"	"No. Just... no."
"dota_chatwheel_label_dark_willow_1"	"ไม่ ก็คือ... ไม่"
"[english]dota_chatwheel_label_dark_willow_1"	"No. Just... no."
"dota_chatwheel_message_dark_willow_2"	"ไม่เคยมีหวังอยู่แล้ว..."
"[english]dota_chatwheel_message_dark_willow_2"	"Never had a chance..."
"dota_chatwheel_label_dark_willow_2"	"ไม่เคยมีหวังอยู่แล้ว"
"[english]dota_chatwheel_label_dark_willow_2"	"Never had a chance."
"dota_chatwheel_message_dark_willow_3"	"โอ้โห อย่ารำคาญข้าเลย ข้าก็แค่นางฟ้าตัวจิ๋ว บินตัวปลิวทำธุระไปตามประสา"
"[english]dota_chatwheel_message_dark_willow_3"	"Oh-ho. Don't mind me. Just a wee fairy going about her business."
"dota_chatwheel_label_dark_willow_3"	"อย่ารำคาญข้าเลย"
"[english]dota_chatwheel_label_dark_willow_3"	"Don't mind me."
"dota_chatwheel_message_dark_willow_4"	"ข้าไม่รู้ว่าข้าคาดหวังอะไรเหมือนกัน"
"[english]dota_chatwheel_message_dark_willow_4"	"I don't know what I was expecting."
"dota_chatwheel_label_dark_willow_4"	"ไม่รู้ว่าข้าคาดหวังอะไรเหมือนกัน"
"[english]dota_chatwheel_label_dark_willow_4"	"Don't know what I was expecting."
"dota_chatwheel_message_dark_willow_5"	"นี่มันไม่เข้าท่าเลยสักนิด"
"[english]dota_chatwheel_message_dark_willow_5"	"This makes absolutely no sense."
"dota_chatwheel_label_dark_willow_5"	"ไม่เข้าท่า"
"[english]dota_chatwheel_label_dark_willow_5"	"Makes no sense."
"dota_chatwheel_message_pangolier_laugh"	"ฮ้าาาา ฮ่า ฮ่าฮ่าฮ่าฮ่า ฮ่าฮ่าฮ่าาา ฮู้วว"
"[english]dota_chatwheel_message_pangolier_laugh"	"Aaaah ha hahahaha hahahaaa huu."
"dota_chatwheel_label_pangolier_laugh"	"หัวเราะ"
"[english]dota_chatwheel_label_pangolier_laugh"	"Laugh"
"dota_chatwheel_message_pangolier_thank"	"นั่นตั้งใจหรือเปล่าน่ะ? ดูเหมือนตั้งใจนะ"
"[english]dota_chatwheel_message_pangolier_thank"	"Was that intentional? It looked intentional."
"dota_chatwheel_label_pangolier_thank"	"นั่นตั้งใจหรือเปล่าน่ะ?"
"[english]dota_chatwheel_label_pangolier_thank"	"Was that intentional?"
"dota_chatwheel_message_pangolier_1"	"ครั้งหน้าพยายามขึ้นอีกหน่อยนะ..."
"[english]dota_chatwheel_message_pangolier_1"	"Try a bit harder next time..."
"dota_chatwheel_label_pangolier_1"	"พยายามขึ้นอีกหน่อยนะ"
"[english]dota_chatwheel_label_pangolier_1"	"Try Harder"
"dota_chatwheel_message_pangolier_2"	"นั่นดูไม่ค่อยดีเลยนะ"
"[english]dota_chatwheel_message_pangolier_2"	"That does not look good."
"dota_chatwheel_label_pangolier_2"	"ดูไม่ค่อยดีนะ"
"[english]dota_chatwheel_label_pangolier_2"	"Not look good"
"dota_chatwheel_message_pangolier_3"	"ปี๊น ปี๊น!"
"[english]dota_chatwheel_message_pangolier_3"	"Beep Beep!"
"dota_chatwheel_label_pangolier_3"	"ปี๊น ปี๊น!"
"[english]dota_chatwheel_label_pangolier_3"	"Beep Beep!"
}
