"lang"
{
"Language"	"korean"
"Tokens"
{
"addon_game_name"	"타도"
"[english]addon_game_name"	"Overthrow"
"DOTA_Tooltip_modifier_get_xp"	"황금 오라"
"[english]DOTA_Tooltip_modifier_get_xp"	"Golden Aura"
"DOTA_Tooltip_modifier_get_xp_Description"	"더 많은 골드와 경험치를 획득하는 중!"
"[english]DOTA_Tooltip_modifier_get_xp_Description"	"Gaining more gold and experience!"
"DOTA_Tooltip_modifier_get_xp_global"	"광역 오라"
"[english]DOTA_Tooltip_modifier_get_xp_global"	"Global Aura"
"DOTA_Tooltip_modifier_get_xp_global_Description"	"골드와 경험치 획득 중"
"[english]DOTA_Tooltip_modifier_get_xp_global_Description"	"Gaining gold and experience"
"DOTA_Tooltip_modifier_fountain_aura_effect_lua"	"분수 오라"
"[english]DOTA_Tooltip_modifier_fountain_aura_effect_lua"	"Fountain Aura"
"DOTA_Tooltip_modifier_fountain_aura_effect_lua_Description"	"치유 중"
"[english]DOTA_Tooltip_modifier_fountain_aura_effect_lua_Description"	"Healing"
"DOTA_Tooltip_ability_item_bag_of_gold"	"300 골드"
"[english]DOTA_Tooltip_ability_item_bag_of_gold"	"300 Gold"
"DOTA_Tooltip_ability_item_treasure_chest"	"보물 상자"
"[english]DOTA_Tooltip_ability_item_treasure_chest"	"Treasure Chest"
"PointsToWin"	"+{d:points_to_win}점 더"
"[english]PointsToWin"	"+{d:points_to_win} more"
"PointsToWin_CloseToVictory"	"+{d:points_to_win}점 더"
"[english]PointsToWin_CloseToVictory"	"+{d:points_to_win} more"
"PointsToWin_VeryCloseToVictory"	"+{d:points_to_win}점 더!"
"[english]PointsToWin_VeryCloseToVictory"	"+{d:points_to_win} more!"
"PointsToWin_Victory"	"승리!"
"[english]PointsToWin_Victory"	"Victory!"
"InstructionsTitle"	"타도"
"[english]InstructionsTitle"	"OVERTHROW"
"InstructionsObjective"	"목표"
"[english]InstructionsObjective"	"OBJECTIVE"
"InstructionsObjectiveText"	"적을 섬멸하세요! 가장 먼저 목표 횟수만큼 처치하거나 라운드가 종료될 때 팀으로 최다 처치를 기록하면 승리를 거둡니다."
"[english]InstructionsObjectiveText"	"Slay your enemies! Be the first to earn the goal number of kills, or the team with the most kills when the round ends, and you will be victorious."
"InstructionsHowToPlay"	"플레이 방법"
"[english]InstructionsHowToPlay"	"HOW TO PLAY"
"InstructionsLines"	"- 미다스 왕좌에 가까이 가서 보너스 골드와 경험치를 획득하세요.<br>
- 과대 우두머리가 던지는 거대 동전을 낚아채 더 많은 골드를 획득하세요.<br>
- 배달되는 아이템을 계속 지켜보세요. 아이템이 나타나는 위치가 지도 위에 아이콘으로 표시됩니다.<br>
- 팀의 처치 수가 적을수록, 더 좋은 아이템을 배달받습니다.<br>
- 같은 팀이 아니면 모두 처치하세요."
"[english]InstructionsLines"	"-Approach the Midas Throne to earn bonus gold and experience.<br>
													-Snatch up any giant coins the Over Boss tosses to earn even more gold.<br>
													-Keep an eye out for item deliveries. An icon will appear on your map where an item will appear.<br>
													-The fewer kills your team has, the better the item you will receive from a delivery.<br>
													-Slay anyone who isn't on your team."
"Chest"	"아이템이"
"[english]Chest"	"ITEM"
"ItemWillSpawn"	"배달될 예정입니다!"
"[english]ItemWillSpawn"	"IS ABOUT TO BE DELIVERED!"
"ItemHasSpawned"	"배달 중입니다!"
"[english]ItemHasSpawned"	"IS ON ITS WAY!"
"Unassigned"	"미지정 팀"
"[english]Unassigned"	"Unassigned Team"
"Spectator"	"관전자 팀"
"[english]Spectator"	"Spectator Team"
"Neutrals"	"중립 팀"
"[english]Neutrals"	"Neutral Team"
"NoTeam"	"팀 없음"
"[english]NoTeam"	"No Team"
"DOTA_GoodGuys"	"청록색 호랑이"
"[english]DOTA_GoodGuys"	"Teal Tiger"
"DOTA_BadGuys"	"노란색 원숭이"
"[english]DOTA_BadGuys"	"Yellow Monkey"
"DOTA_Custom1"	"분홍색 용"
"[english]DOTA_Custom1"	"Pink Dragon"
"DOTA_Custom2"	"주황색 개"
"[english]DOTA_Custom2"	"Orange Dog"
"DOTA_Custom3"	"파란색 수탉"
"[english]DOTA_Custom3"	"Blue Rooster"
"DOTA_Custom4"	"초록색 양"
"[english]DOTA_Custom4"	"Green Ram"
"DOTA_Custom5"	"갈색 쥐"
"[english]DOTA_Custom5"	"Brown Rat"
"DOTA_Custom6"	"하늘색 멧돼지"
"[english]DOTA_Custom6"	"Cyan Boar"
"DOTA_Custom7"	"황록색 뱀"
"[english]DOTA_Custom7"	"Olive Snake"
"DOTA_Custom8"	"보라색 말"
"[english]DOTA_Custom8"	"Purple Horse"
"OverthrowTextPickup"	"획득한 아이템:"
"[english]OverthrowTextPickup"	"HAS PICKED UP"
"Remaining"	"남음"
"[english]Remaining"	"REMAINING"
"Overtime"	"시간 초과!"
"[english]Overtime"	"OVERTIME!"
"OvertimeInstructions"	"승리까지 필요 점수"
"[english]OvertimeInstructions"	"SCORE TO WIN"
"KillMessageText"	"선두를 처치하여"
"[english]KillMessageText"	"HAS KILLED THE LEADER"
"KillMessageBounty"	"보너스 500골드를 획득했습니다!"
"[english]KillMessageBounty"	"FOR 500 BONUS GOLD!"
"addonname"	"타도"
"[english]addonname"	"Overthrow"
"overthrow_game_info_header_objective"	"목표:"
"[english]overthrow_game_info_header_objective"	"Objective:"
"overthrow_brief_description"	"적을 모조리 쓸어버리세요! 처치 한도를 가장 먼저 달성한 팀이 승리합니다!"
"[english]overthrow_brief_description"	"Slay your enemies! First team to hit the kill limit wins!"
"overthrow_game_info_header_how_to_play"	"플레이 방법:"
"[english]overthrow_game_info_header_how_to_play"	"How To Play:"
"overthrow_game_info_throne"	"<span class='midas_throne'>미다스 왕좌</span>에 가까이 가서 보너스 <span class='gold'>골드</span>와 <span class='xp'>경험치</span>를 획득하세요."
"[english]overthrow_game_info_throne"	"Approach the <span class='midas_throne'>Midas Throne</span> to earn bonus <span class='gold'>gold</span> and <span class='xp'>experience</span>."
"overthrow_game_info_coins"	"<span class='overboss'>과대 우두머리</span>가 던지는 거대 동전을 낚아채 더 많은 <span class='gold'>골드</span>를 획득하세요."
"[english]overthrow_game_info_coins"	"Snatch up coins the <span class='overboss'>Overboss</span> tosses to earn more <span class='gold'>gold</span>."
"overthrow_game_info_items"	"<span class='treasure'>보물</span> 배달을 계속 지켜보세요. <span class='items'>아이템</span>이 나타나는 위치가 지도 위에 아이콘으로 표시됩니다."
"[english]overthrow_game_info_items"	"Keep an eye out for <span class='treasure'>treasure</span> deliveries. An icon will appear on your map where an <span class='items'>item</span> will appear."
"overthrow_game_info_tips_header"	"팁:"
"[english]overthrow_game_info_tips_header"	"Tips:"
"overthrow_game_info_tip01"	"현재 선두에게는 황금 왕관이 표시됩니다. 선두를 처치하면 추가 골드를 얻습니다."
"[english]overthrow_game_info_tip01"	"The current leader has a gold crown, and you will get extra gold for killing them."
"overthrow_game_info_tip02"	"아이템은 팀원에게 주거나 기지에서 팔 수 있습니다."
"[english]overthrow_game_info_tip02"	"Items can be given to teammates or sold at your base."
"overthrow_game_info_tip03"	"강력한 적을 제거하려면 다른 팀과 협동해야 할 수도 있습니다."
"[english]overthrow_game_info_tip03"	"You may need to coordinate with an opposing team to take out a strong opponent."
"overthrow_game_info_tip04"	"팀의 처치 수가 적을수록, 더 강력한 아이템을 배달받습니다."
"[english]overthrow_game_info_tip04"	"The fewer kills your team has, the stronger items you will recieve from a delivery."
"npc_dota_hero_bounty_hunter"	"현상금 사냥꾼(조정됨)"
"[english]npc_dota_hero_bounty_hunter"	"Bounty Hunter (Modified)"
"npc_dota_hero_broodmother"	"거미여왕(조정됨)"
"[english]npc_dota_hero_broodmother"	"Broodmother (Modified)"
"npc_dota_hero_necrolyte"	"강령사제(조정됨)"
"[english]npc_dota_hero_necrolyte"	"Necrophos (Modified)"
"npc_dota_hero_riki"	"리키(조정됨)"
"[english]npc_dota_hero_riki"	"Riki (Modified)"
"npc_dota_hero_silencer"	"침묵술사(조정됨)"
"[english]npc_dota_hero_silencer"	"Silencer (Modified)"
"npc_dota_hero_zuus"	"제우스(조정됨)"
"[english]npc_dota_hero_zuus"	"Zeus (Modified)"
"npc_dota_hero_pudge"	"퍼지(조정됨)"
"[english]npc_dota_hero_pudge"	"Pudge (Modified)"
"DOTA_Tooltip_Ability_item_ward_sentry"	"감시 와드(조정됨)"
"[english]DOTA_Tooltip_Ability_item_ward_sentry"	"Sentry Ward (Modified)"
"DOTA_Tooltip_Ability_item_dust"	"현시의 가루(조정됨)"
"[english]DOTA_Tooltip_Ability_item_dust"	"Dust of Appearance (Modified)"
"DOTA_Tooltip_ability_bounty_hunter_wind_walk_Description"	"현상금 사냥꾼이 투명 상태가 되어 다른 유닛을 통과하여 이동할 수 있습니다. 공격을 가하거나 능력을 사용하면 투명화가 풀립니다. 투명 상태에서 적을 공격하면 추가 피해를 줍니다.\n\n<font color='#70EA72'>타도에서는 바람걸음으로 쿨다운, 마나 소모, 투명화 진입 시간이 증가하는 반면, 지속시간과 보너스 피해가 감소합니다.</font>"
"[english]DOTA_Tooltip_ability_bounty_hunter_wind_walk_Description"	"Bounty Hunter becomes invisible and gains the ability to move through other units until he attacks or uses an ability.  If he breaks the invisibility with an attack, that attack will deal bonus damage.\n\n<font color='#70EA72'>Wind Walk has increased cooldown, mana cost, and fade time, while it has reduced duration and bonus damage in Overthrow.</font>"
"DOTA_Tooltip_ability_broodmother_spin_web_Description"	"거미여왕이 거대한 거미줄을 칩니다. 거미여왕은 거미줄 안에 있는 동안 투명해지고, 이동 속도가 증가하며, 지형에 제약받지 않고 이동할 수 있습니다. 또한 거미줄 주변에서는 체력 재생이 증가합니다. %charge_restore_time%초마다 거미줄 치기 효과가 1개 충전됩니다. 거미여왕이 피해를 받으면 %damage_time%초 동안 이동 제약 무시 효과가 사라지고 %damage_time%초 동안 이동 속도 증가 효과가 절반으로 감소합니다. 새로운 거미줄이 기존 거미줄과 이어지기만 한다면 어디든 거미줄을 칠 수 있습니다. 거미줄은 시간이 지나도 사라지지 않지만 거미여왕이 직접 제거할 수 있습니다. 최대 거미줄 개수를 초과하면 가장 오래된 거미줄이 사라집니다.\n\n<font color='#70EA72'>타도에서는 거미줄 치기의 충전 횟수, 체력 재생, 보너스 이동 속도가 감소합니다.</font>"
"[english]DOTA_Tooltip_ability_broodmother_spin_web_Description"	"Spins a large web that renders Broodmother invisible, grants a passive movement speed increase, gives free movement, and boosts regeneration while in its vicinity. Spin Web charges restore every %charge_restore_time% seconds. If damage is taken, free movement is disabled and the movement speed increase is halved for %damage_time% seconds. Spin Web can be cast from anywhere as long as the new web touches an existing web. Webs never expire, and can be manually destroyed. When the maximum limit of webs is exceeded, the oldest web disappears.\n\n<font color='#70EA72'>Spin Web has reduced count, health regen, and bonus movement speed for Overthrow.</font>"
"DOTA_Tooltip_ability_necrolyte_reapers_scythe_Description"	"적 영웅을 기절시킨 후 대상이 현재 잃은 체력에 비례한 피해를 줍니다.\n\n<font color='#70EA72'>타도에서는 사신의 낫에 죽은 영웅의 부활 시간이 20초 증가합니다.</font>\n\n사신의 낫 효과를 받고 있는 적이 죽으면 강령사제가 처치한 것으로 취급합니다.\n\n아가님의 홀로 강화 가능"
"[english]DOTA_Tooltip_ability_necrolyte_reapers_scythe_Description"	"Stuns the target enemy hero, then deals damage based on how much life it is missing.\n\n<font color='#70EA72'>In Overthrow, heroes killed by Reaper's Scythe will have 20 seconds added to their respawn timer.</font>\n\nAny kill under this effect is credited to Necrophos.\n\nUpgradable by Aghanim's Scepter."
"DOTA_Tooltip_ability_riki_permanent_invisibility_Description"	"리키가 그림자 속에 숨어들어 투명 상태가 되며 추가 체력 재생 효과를 얻습니다. 리키가 적을 공격하면 투명 상태에서 풀려납니다.\n\n<font color='#70EA72'>타도에서는 숨어 찌르기 진입 시간과 투명화 지연시간이 증가합니다.</font>"
"[english]DOTA_Tooltip_ability_riki_permanent_invisibility_Description"	"Riki fades into the shadows, becoming invisible and gaining additional health regeneration.  If Riki attacks an enemy, he will become visible.\n\n<font color='#70EA72'>Cloak and Dagger's fade time and fade delay have been increased for Overthrow.</font>"
"DOTA_Tooltip_ability_riki_blink_strike_Description"	"대상 유닛의 뒤로 순간이동합니다. 대상이 적일 경우 공격 시 보너스 피해를 줍니다. \n\n<font color='#70EA72'>타도에서는 점멸 가격의 범위가 감소하고 보너스 피해를 줍니다.</font>"
"[english]DOTA_Tooltip_ability_riki_blink_strike_Description"	"Teleports behind the target unit, striking for bonus damage if it is an enemy. \n\n<font color='#70EA72'>In Overthrow, Blink Strike has reduced range and bonus damage.</font>"
"DOTA_Tooltip_ability_silencer_glaives_of_wisdom_Description"	"침묵술사가 무기에 자신의 지혜를 부여하여 지능에 비례하는 추가 피해를 줍니다.\n\n지혜의 날은 고유 공격 변형 요인입니다. 다른 고유 공격 변형 요인과 중첩되지 않습니다.\n\n<font color='#70EA72'>타도에서는 지혜의 날로 주는 추가 피해의 비율과 범위가 감소합니다.</font>"
"[english]DOTA_Tooltip_ability_silencer_glaives_of_wisdom_Description"	"Silencer enchants his glaives with his wisdom, dealing additional damage based on his Intelligence. \n\nGlaives of Wisdom is a Unique Attack Modifier, and does not stack with other Unique Attack Modifiers.\n\n<font color='#70EA72'>Glaives of Wisdom intelligence percentage and range is reduced in Overthrow.</font>"
"DOTA_Tooltip_ability_zuus_thundergods_wrath_Description"	"지도상의 모든 적 영웅을 번개로 내려칩니다. 또한 천둥신의 분노에 맞은 적의 위치에 진실의 시야가 밝혀집니다. 적 영웅이 투명 상태일 때는 피해를 받지 않고 해당 유닛 주위에 진실의 시야가 밝혀집니다.\n\n아가님의 홀로 강화 가능\n\n<font color='#70EA72'>타도에서는 천둥신의 분노 쿨다운과 마나 소모가 증가하고 피해가 감소합니다.</font>"
"[english]DOTA_Tooltip_ability_zuus_thundergods_wrath_Description"	"Strikes all enemy heroes with a bolt of lightning, no matter where they may be.  Thundergod's Wrath also provides True Sight around each hero struck.  If an enemy hero is invisible, it takes no damage, but the True Sight is still created at that hero's location.\n\nUpgradable by Aghanim's Scepter.\n\n<font color='#70EA72'>Thundergod's Wrath has increased cooldown and mana cost and has reduced damage in Overthrow.</font>"
"DOTA_Tooltip_ability_pudge_flesh_heap_Description"	"마법 피해에 대한 퍼지의 저항력이 증가하고, 적 영웅을 죽이거나 인근에서 적 영웅이 죽을 때마다 보너스 힘을 얻습니다. 살점 무더기 능력을 익히기 전에 발생한 적 영웅의 죽음도 소급되어 적용됩니다.\n\n<font color='#70EA72'>타도에서는 살점 무더기의 보너스 힘과 범위가 감소합니다.</font>"
"[english]DOTA_Tooltip_ability_pudge_flesh_heap_Description"	"Gives Pudge resistance to magic damage, as well as bonus strength that increases each time Pudge kills an enemy Hero or it dies in his vicinity.  Flesh Heap is retroactive, meaning it can gain charges before it is skilled, which then become active.\n\n<font color='#70EA72'>Flesh Heap's bonus strength and range have been reduced in Overthrow.</font>"
"DOTA_Tooltip_ability_item_ward_sentry_Description"	"사용: 눈에 보이지 않는 감시 와드를 설치합니다. 해당 범위에 있는 아군은 진실의 시야를 얻어 투명 적 유닛과 와드를 볼 수 있습니다. %duration_minutes_tooltip%분 동안 지속합니다.\n\nCtrl 키를 누르고 아군을 클릭하면 감시 와드 하나를 넣어줄 수 있습니다.\n\n<font color='#70EA72'>타도에서는 감시 와드가 6분간 지속하며, 100골드로 구매합니다.</font>"
"[english]DOTA_Tooltip_ability_item_ward_sentry_Description"	"Use: Plants a Sentry Ward, an invisible watcher that grants True Sight, the ability to see invisible enemy units and wards, to any existing allied vision within its range. Lasts %duration_minutes_tooltip% minutes.\n\nHold Control to give one Sentry Ward to an allied hero.\n\n<font color='#70EA72'>In Overthrow, Sentry Wards cost 100 gold and last 6 minutes.</font>"
"DOTA_Tooltip_ability_item_dust_Description"	"사용: 주위의 투명화된 영웅을 밝히고 둔화 상태에 빠뜨립니다.\n\n<font color='#70EA72'>타도에서는 현시의 가루 쿨다운이 감소하며 90골드로 구매합니다.</font>"
"[english]DOTA_Tooltip_ability_item_dust_Description"	"Use: Reveals and slows invisible Heroes in a nearby area.\n\n<font color='#70EA72'>In Overthrow, Dust of Appearance costs 90 gold and has a reduced cooldown.</font>"
"npc_dota_hero_obsidian_destroyer"	"외계 침략자(조정됨)"
"[english]npc_dota_hero_obsidian_destroyer"	"Outworld Devourer (Modified)"
"DOTA_Tooltip_ability_obsidian_destroyer_arcane_orb_Description"	"외계 침략자의 공격에 현재 남아 있는 마나의 양에 비례하는 순수 피해를 추가합니다. 적 영웅을 공격할 때 %int_steal_duration%초 동안 타격당 지능을 %int_steal% 훔칩니다. 또한 소환된 유닛과 환영에 보너스 피해를 줍니다.\n\n비전 구체는 고유 공격 변형 요인입니다. 다른 고유 공격 변형 요인과 중첩되지 않습니다.\n\n<font color='#70EA72'>타도에서는 비전 구체의 마나 양 비율과 훔치는 지능, 지속시간이 감소합니다.</font>"
"[english]DOTA_Tooltip_ability_obsidian_destroyer_arcane_orb_Description"	"Adds extra pure damage to Outworld Devourer's attacks, based on his remaining mana pool. Steals %int_steal% intelligence for %int_steal_duration% seconds per hit when attacking an enemy hero. Arcane Orb also does bonus damage to summoned units and illusions.\n\nArcane Orb is a Unique Attack Modifier, and does not stack with other Unique Attack Modifiers.\n\n<font color='#70EA72'>Arcane Orb's mana pool percentage, intelligence steal, and duration have been reduced in Overthrow.</font>"
"DOTA_GameMode_15"	"타도"
"[english]DOTA_GameMode_15"	"Overthrow"
}
}
