"lang"
{
"Language"	"korean"
"Tokens"
{
"game_mode_15"	"서리축제"
"[english]game_mode_15"	"The Frostivus Festival"
"addon_game_name"	"서리축제"
"[english]addon_game_name"	"The Frostivus Festival"
"DOTA_Tooltip_ability_item_bag_of_gold"	"동전"
"[english]DOTA_Tooltip_ability_item_bag_of_gold"	"Coin"
"DOTA_GameMode_15"	"어둠달"
"[english]DOTA_GameMode_15"	"Dark Moon"
"DOTA_GameMode_19"	"어둠달"
"[english]DOTA_GameMode_19"	"Dark Moon"
"DOTA_HUD_Round"	"라운드"
"[english]DOTA_HUD_Round"	"ROUND"
"DOTA_HUD_EnemiesRemaining"	"남은 적:"
"[english]DOTA_HUD_EnemiesRemaining"	"ENEMIES REMAINING:"
"DOTA_HUD_NextRound"	"다음 라운드:"
"[english]DOTA_HUD_NextRound"	"NEXT ROUND: "
"DOTA_HUD_RoundStart"	"라운드 시작!"
"[english]DOTA_HUD_RoundStart"	"ROUND START!"
"DOTA_HUD_Victory"	"승리!"
"[english]DOTA_HUD_Victory"	"VICTORY!"
"DOTA_HUD_Defeat"	"패배!"
"[english]DOTA_HUD_Defeat"	"DEFEAT!"
"DOTA_HUD_Kills"	"처치"
"[english]DOTA_HUD_Kills"	"KILLS"
"DOTA_HUD_Deaths"	"죽음"
"[english]DOTA_HUD_Deaths"	"DEATHS"
"DOTA_HUD_Saves"	"부활"
"[english]DOTA_HUD_Saves"	"REVIVES"
"DOTA_HUD_Bags"	"주머니"
"[english]DOTA_HUD_Bags"	"BAGS"
"DOTA_HUD_PlayAgain"	"다시 하시겠습니까?"
"[english]DOTA_HUD_PlayAgain"	"Play Again?"
"DOTA_HUD_Yes"	"예"
"[english]DOTA_HUD_Yes"	"YES"
"DOTA_HUD_No"	"아니요"
"[english]DOTA_HUD_No"	"NO"
"DOTA_HUD_Score"	"라운드 점수"
"[english]DOTA_HUD_Score"	"ROUND SCORE"
"DOTA_HUD_TowersRemaining"	"남은 포탑"
"[english]DOTA_HUD_TowersRemaining"	"TOWERS REMAINING"
"DOTA_HUD_GoldBags"	"수집한 돈주머니"
"[english]DOTA_HUD_GoldBags"	"GOLD BAGS COLLECTED"
"DOTA_HUD_GoldBagsMissed"	"놓친 돈주머니"
"[english]DOTA_HUD_GoldBagsMissed"	"GOLD BAGS MISSED"
"DOTA_HUD_TeamDeaths"	"팀 사망 수"
"[english]DOTA_HUD_TeamDeaths"	"TEAM DEATHS"
"DOTA_HUD_DarkMoonPoints"	"점"
"[english]DOTA_HUD_DarkMoonPoints"	"POINTS"
"DOTA_HUD_ThisRound"	"이번 라운드 획득 점수"
"[english]DOTA_HUD_ThisRound"	"POINTS THIS ROUND"
"DOTA_HUD_TotalPoints"	"이번 매치에서 획득한 총 점수"
"[english]DOTA_HUD_TotalPoints"	"TOTAL POINTS EARNED THIS MATCH"
"DOTA_HUD_RankThisRound"	"이번 라운드 등급"
"[english]DOTA_HUD_RankThisRound"	"RANK THIS ROUND"
"DOTA_HUD_RankInfoIcon"	"등급은 남은 포탑, 수집한 돈주머니, 총 팀 사망 수 결과를 바탕으로 결정됩니다. 획득한 점수는 등급의 영향을 받지 않습니다."
"[english]DOTA_HUD_RankInfoIcon"	"Rank is determined based off performance on Towers Remaining, Gold Bags Collected, and Total Team Deaths.  Points earned are not affected by Rank."
"DOTA_HUD_Mute"	"차단"
"[english]DOTA_HUD_Mute"	"MUTE"
"taunt_game_creep"	"크립"
"[english]taunt_game_creep"	"Creep"
"suicidal_pudge"	"자살하려는 퍼지"
"[english]suicidal_pudge"	"Suicidal Pudge"
"custom_necrophos"	"강령술사"
"[english]custom_necrophos"	"Necrolyte"
"bloodseeker_game_bloodseeker"	"혈귀"
"[english]bloodseeker_game_bloodseeker"	"Bloodseeker"
"chain_frost_game_lich"	"리치"
"[english]chain_frost_game_lich"	"Lich"
"chain_frost_game_penguin"	"펭귄"
"[english]chain_frost_game_penguin"	"Penguin"
"mirana_game_bell"	"종"
"[english]mirana_game_bell"	"Bell"
"techies_game_remote_mine"	"원격 지뢰"
"[english]techies_game_remote_mine"	"Remote Mine"
"zuus_race_land_mine"	"지뢰"
"[english]zuus_race_land_mine"	"Land Mine"
"zuus_race_stasis_trap"	"정지 덫"
"[english]zuus_race_stasis_trap"	"Stasis Trap"
"monkey_king_real"	"원숭이 왕"
"[english]monkey_king_real"	"Monkey King"
"monkey_king_fake"	"원숭이 왕 아님"
"[english]monkey_king_fake"	"Not Monkey King"
"vision_dummy"	"시야 모형"
"[english]vision_dummy"	"Vision Dummy"
"npc_dota_creature_ogre_tank"	"오거 덩치전사"
"[english]npc_dota_creature_ogre_tank"	"Ogre Tank"
"npc_dota_creature_ogre_tank_boss"	"오거 덩치전사 우두머리"
"[english]npc_dota_creature_ogre_tank_boss"	"Ogre Tank Boss"
"earth_spirit_soccer_ball"	"축구공"
"[english]earth_spirit_soccer_ball"	"Soccer Ball"
"earth_spirit_soccer_goal"	"축구공"
"[english]earth_spirit_soccer_goal"	"Soccer Goal"
"npc_dota_creature_ogre_seal"	"오거 바다표범"
"[english]npc_dota_creature_ogre_seal"	"Ogre Seal"
"npc_dummy_unit"	"모형 유닛"
"[english]npc_dummy_unit"	"Dummy Unit"
"npc_dota_fire_trap_ward"	"화염 함정"
"[english]npc_dota_fire_trap_ward"	"Fire Trap"
"custom_undying_tombstone"	"묘비"
"[english]custom_undying_tombstone"	"Tombstone"
"custom_creature_zombie"	"좀비"
"[english]custom_creature_zombie"	"Zombie"
"propulsion_mine"	"추진 지뢰"
"[english]propulsion_mine"	"Propulsion Mine"
"npc_dota_weather_dummy"	"도타 날씨 모형"
"[english]npc_dota_weather_dummy"	"Dota Weather Dummy"
"npc_dota_campfire"	"모닥불"
"[english]npc_dota_campfire"	"Campfire"
"custom_invoker"	"원소술사"
"[english]custom_invoker"	"Invoker"
"invoker_leader_forge_spirit"	"달구어진 영혼"
"[english]invoker_leader_forge_spirit"	"Forge Spirit"
"DOTA_Tooltip_modifier_aoe_rupture_lua"	"파열"
"[english]DOTA_Tooltip_modifier_aoe_rupture_lua"	"Rupture"
"DOTA_Tooltip_modifier_aoe_rupture_lua_Description"	"이동 시 피해받음"
"[english]DOTA_Tooltip_modifier_aoe_rupture_lua_Description"	"Taking damage on movement."
"DOTA_Tooltip_modifier_heartstopper_aura_visible"	"심장마비의 오라"
"[english]DOTA_Tooltip_modifier_heartstopper_aura_visible"	"Heartstopper Aura"
"DOTA_Tooltip_modifier_heartstopper_aura_visible_Description"	"지속하여 피해받음"
"[english]DOTA_Tooltip_modifier_heartstopper_aura_visible_Description"	"Taking damage over time."
"DOTA_Tooltip_modifier_sun_strike_datadriven"	"태양 강타 데이터 처리"
"[english]DOTA_Tooltip_modifier_sun_strike_datadriven"	"Sun Strike Datadriven"
"DOTA_Tooltip_modifier_sun_strike_datadriven_Description"	""
"[english]DOTA_Tooltip_modifier_sun_strike_datadriven_Description"	""
"DOTA_Tooltip_modifier_weather_snowstorm_cold"	"얼어붙기 전에 모닥불을 찾으세요!"
"[english]DOTA_Tooltip_modifier_weather_snowstorm_cold"	"Find a Campfire before you start to freeze!"
"DOTA_Tooltip_modifier_weather_snowstorm_effect"	"빙결"
"[english]DOTA_Tooltip_modifier_weather_snowstorm_effect"	"Freezing"
"DOTA_Tooltip_modifier_weather_snowstorm_effect_Description"	"추위 때문에 주기적으로 피해받음"
"[english]DOTA_Tooltip_modifier_weather_snowstorm_effect_Description"	"Taking periodic damage from the cold"
"DOTA_Tooltip_modifier_campfire_effect"	"모닥불"
"[english]DOTA_Tooltip_modifier_campfire_effect"	"Campfire"
"DOTA_Tooltip_modifier_campfire_effect_Description"	"추위 효과를 제거합니다."
"[english]DOTA_Tooltip_modifier_campfire_effect_Description"	"Removes the effects of cold."
"DOTA_Tooltip_modifier_invoked_spell_to_cast"	"시전할 주문"
"[english]DOTA_Tooltip_modifier_invoked_spell_to_cast"	"Spell To Cast"
"DOTA_Tooltip_modifier_invoked_spell_to_cast_Description"	"이 주문을 조합하지 못하면 피해를 받습니다."
"[english]DOTA_Tooltip_modifier_invoked_spell_to_cast_Description"	"Invoke this spell or take damage."
"DOTA_Tooltip_modifier_rupture_damage"	"파열"
"[english]DOTA_Tooltip_modifier_rupture_damage"	"Rupture"
"DOTA_Tooltip_modifier_berserkers_call_lua"	"광전사의 외침"
"[english]DOTA_Tooltip_modifier_berserkers_call_lua"	"Berserkers Call"
"DOTA_Tooltip_modifier_campfire"	"모닥불"
"[english]DOTA_Tooltip_modifier_campfire"	"Campfire"
"DOTA_Tooltip_modifier_provides_fow_position"	"전장의 안개 위치 제공"
"[english]DOTA_Tooltip_modifier_provides_fow_position"	"Provides FOW Position"
"DOTA_Tooltip_modifier_chain_frost_lua"	"연쇄 빙결"
"[english]DOTA_Tooltip_modifier_chain_frost_lua"	"Chain Frost"
"DOTA_Tooltip_modifier_conjure_image_lua"	"환영 창조"
"[english]DOTA_Tooltip_modifier_conjure_image_lua"	"Conjure Image"
"DOTA_Tooltip_modifier_illusion_out_of_world"	"저 세상의 환영"
"[english]DOTA_Tooltip_modifier_illusion_out_of_world"	"Illusion Out Of World"
"DOTA_Tooltip_modifier_shoot_arrow_lua"	"화살 기절"
"[english]DOTA_Tooltip_modifier_shoot_arrow_lua"	"Arrow Stun"
"DOTA_Tooltip_modifier_teleport_channel_lua"	"순간이동"
"[english]DOTA_Tooltip_modifier_teleport_channel_lua"	"Teleport"
"DOTA_Tooltip_modifier_greater_bash_lua"	"혼신의 강타"
"[english]DOTA_Tooltip_modifier_greater_bash_lua"	"Greater Bash"
"DOTA_Tooltip_modifier_heartstopper_aura_lua"	"심장마비의 오라"
"[english]DOTA_Tooltip_modifier_heartstopper_aura_lua"	"Heartstopper Aura"
"DOTA_Tooltip_modifier_quas_lua"	"콰스"
"[english]DOTA_Tooltip_modifier_quas_lua"	"Quas"
"DOTA_Tooltip_modifier_wex_lua"	"웩스"
"[english]DOTA_Tooltip_modifier_wex_lua"	"Wex"
"DOTA_Tooltip_modifier_exort_lua"	"익조트"
"[english]DOTA_Tooltip_modifier_exort_lua"	"Exort"
"DOTA_Tooltip_modifier_leader_cold_snap_lua"	"한파"
"[english]DOTA_Tooltip_modifier_leader_cold_snap_lua"	"Cold Snap"
"DOTA_Tooltip_modifier_rabid_lua"	"광증"
"[english]DOTA_Tooltip_modifier_rabid_lua"	"Rabid"
"DOTA_Tooltip_modifier_arrow_lua"	"화살"
"[english]DOTA_Tooltip_modifier_arrow_lua"	"Arrow"
"DOTA_Tooltip_modifier_health_lua"	"체력"
"[english]DOTA_Tooltip_modifier_health_lua"	"Health"
"DOTA_Tooltip_modifier_hidden_lua"	"감춤"
"[english]DOTA_Tooltip_modifier_hidden_lua"	"Hidden"
"DOTA_Tooltip_modifier_invisible_lua"	"투명화"
"[english]DOTA_Tooltip_modifier_invisible_lua"	"Invisible"
"DOTA_Tooltip_modifier_mana_lua"	"마나"
"[english]DOTA_Tooltip_modifier_mana_lua"	"Mana"
"DOTA_Tooltip_modifier_ogre_tank_melee_smash_thinker"	"오거 근접 강타 사색가"
"[english]DOTA_Tooltip_modifier_ogre_tank_melee_smash_thinker"	"Ogre Melee Smash Thinker"
"DOTA_Tooltip_modifier_ogreseal_flop"	"오거 바다표범 철퍽"
"[english]DOTA_Tooltip_modifier_ogreseal_flop"	"Ogreseal Flop"
"DOTA_Tooltip_modifier_provide_vision_lua"	"시야 제공"
"[english]DOTA_Tooltip_modifier_provide_vision_lua"	"Provide Vision"
"DOTA_Tooltip_modifier_rooted_lua"	"묶임"
"[english]DOTA_Tooltip_modifier_rooted_lua"	"Rooted"
"DOTA_Tooltip_modifier_rot_lua"	"썩은 내"
"[english]DOTA_Tooltip_modifier_rot_lua"	"Rot"
"DOTA_Tooltip_modifier_stunned_lua"	"기절함"
"[english]DOTA_Tooltip_modifier_stunned_lua"	"Stunned"
"DOTA_Tooltip_modifier_vision_dummy"	"모형"
"[english]DOTA_Tooltip_modifier_vision_dummy"	"Dummy"
"DOTA_Tooltip_modifier_ogreseal_flying"	"오거 바다표범 지속 효과"
"[english]DOTA_Tooltip_modifier_ogreseal_flying"	"Ogreseal Passive"
"DOTA_Tooltip_modifier_propulsion_mine"	"추진 지뢰"
"[english]DOTA_Tooltip_modifier_propulsion_mine"	"Propulsion Mine"
"DOTA_Tooltip_modifier_proximity_mine"	"근접 지뢰"
"[english]DOTA_Tooltip_modifier_proximity_mine"	"Proximity Mine"
"DOTA_Tooltip_modifier_refraction_lua"	"굴절의 보호막"
"[english]DOTA_Tooltip_modifier_refraction_lua"	"Refraction"
"DOTA_Tooltip_modifier_remote_mine"	"원격 지뢰"
"[english]DOTA_Tooltip_modifier_remote_mine"	"Remote Mine"
"DOTA_Tooltip_modifier_shapeshift_bear"	"곰 변신"
"[english]DOTA_Tooltip_modifier_shapeshift_bear"	"Shapeshift Bear"
"DOTA_Tooltip_modifier_shapeshift_boar"	"멧돼지 변신"
"[english]DOTA_Tooltip_modifier_shapeshift_boar"	"Shapeshift Boar"
"DOTA_Tooltip_modifier_shapeshift_hawk"	"매 변신"
"[english]DOTA_Tooltip_modifier_shapeshift_hawk"	"Shapeshift Hawk"
"DOTA_Tooltip_modifier_shapeshift"	"변신"
"[english]DOTA_Tooltip_modifier_shapeshift"	"Shapeshift"
"DOTA_Tooltip_modifier_shukuchi_lua"	"축지술"
"[english]DOTA_Tooltip_modifier_shukuchi_lua"	"Shukuchi"
"DOTA_Tooltip_modifier_snowball"	"눈덩이"
"[english]DOTA_Tooltip_modifier_snowball"	"Snowball"
"DOTA_Tooltip_modifier_stasis_trap"	"정지 덫"
"[english]DOTA_Tooltip_modifier_stasis_trap"	"Stasis Trap"
"DOTA_Tooltip_modifier_stasis_trap_stun"	"기절함"
"[english]DOTA_Tooltip_modifier_stasis_trap_stun"	"Stunned"
"DOTA_Tooltip_modifier_storegga_avalanche_thinker"	"산사태 사색가"
"[english]DOTA_Tooltip_modifier_storegga_avalanche_thinker"	"Avalanche Thinker"
"DOTA_Tooltip_modifier_spawn_zombies"	"좀비 생성"
"[english]DOTA_Tooltip_modifier_spawn_zombies"	"Spawn Zombies"
"DOTA_Tooltip_modifier_weather_dummy_passive"	"모형"
"[english]DOTA_Tooltip_modifier_weather_dummy_passive"	"Dummy"
"DOTA_Tooltip_modifier_weather_snowstorm"	"눈보라"
"[english]DOTA_Tooltip_modifier_weather_snowstorm"	"Snowstorm"
"DOTA_Tooltip_modifier_item_blink_lua"	"점멸"
"[english]DOTA_Tooltip_modifier_item_blink_lua"	"Blink"
"DOTA_Tooltip_modifier_rune_haste"	"신속화"
"[english]DOTA_Tooltip_modifier_rune_haste"	"Haste"
"DOTA_Tooltip_modifier_rune_haste_Description"	""
"[english]DOTA_Tooltip_modifier_rune_haste_Description"	""
"DOTA_Tooltip_modifier_rune_double_damage"	"더블 대미지"
"[english]DOTA_Tooltip_modifier_rune_double_damage"	"Double Damage"
"DOTA_Tooltip_modifier_rune_double_damage_Description"	""
"[english]DOTA_Tooltip_modifier_rune_double_damage_Description"	""
"DOTA_Tooltip_ability_ability_hide_healthbar"	"체력 표시줄 감추기"
"[english]DOTA_Tooltip_ability_ability_hide_healthbar"	"Hide Healthbar"
"DOTA_Tooltip_ability_ability_hide_healthbar_Description"	""
"[english]DOTA_Tooltip_ability_ability_hide_healthbar_Description"	""
"DOTA_Tooltip_ability_vision_dummy_ability"	"시야 모형 능력"
"[english]DOTA_Tooltip_ability_vision_dummy_ability"	"Vision Dummy Ability"
"DOTA_Tooltip_ability_vision_dummy_ability_Description"	""
"[english]DOTA_Tooltip_ability_vision_dummy_ability_Description"	""
"DOTA_Tooltip_ability_custom_berserkers_call"	"광전사의 외침"
"[english]DOTA_Tooltip_ability_custom_berserkers_call"	"Berserker's Call"
"DOTA_Tooltip_ability_custom_berserkers_call_Description"	"도끼전사가 주위 적을 도발하여 자신을 공격하게 합니다. 효과가 지속되는 동안 보너스 방어력을 얻습니다."
"[english]DOTA_Tooltip_ability_custom_berserkers_call_Description"	"Axe taunts nearby enemy units, forcing them to attack him, while he gains bonus armor during the duration."
"DOTA_Tooltip_ability_custom_berserkers_call_radius"	"반경:"
"[english]DOTA_Tooltip_ability_custom_berserkers_call_radius"	"RADIUS:"
"DOTA_Tooltip_ability_custom_berserkers_call_bonus_armor"	"보너스 방어력:"
"[english]DOTA_Tooltip_ability_custom_berserkers_call_bonus_armor"	"BONUS ARMOR:"
"DOTA_Tooltip_ability_custom_berserkers_call_duration"	"지속시간:"
"[english]DOTA_Tooltip_ability_custom_berserkers_call_duration"	"DURATION:"
"DOTA_Tooltip_ability_custom_shadowraze1"	"맞춤 그림자 휩쓸기 1"
"[english]DOTA_Tooltip_ability_custom_shadowraze1"	"Custom Shadowraze1"
"DOTA_Tooltip_ability_custom_shadowraze1_Description"	"그림자 마귀가 전방의 한 지점을 휩쓸어 범위 내의 적 유닛에게 피해를 줍니다."
"[english]DOTA_Tooltip_ability_custom_shadowraze1_Description"	"Shadow Fiend razes the area in front of him, dealing damage to enemy units in an area."
"DOTA_Tooltip_ability_custom_shadowraze1_shadowraze_radius"	"그림자 휩쓸기 반경:"
"[english]DOTA_Tooltip_ability_custom_shadowraze1_shadowraze_radius"	"SHADOWRAZE RADIUS:"
"DOTA_Tooltip_ability_custom_shadowraze1_shadowraze_range"	"그림자 휩쓸기 반경:"
"[english]DOTA_Tooltip_ability_custom_shadowraze1_shadowraze_range"	"SHADOWRAZE RANGE:"
"DOTA_Tooltip_ability_custom_shadowraze2"	"맞춤 그림자 휩쓸기 2"
"[english]DOTA_Tooltip_ability_custom_shadowraze2"	"Custom Shadowraze2"
"DOTA_Tooltip_ability_custom_shadowraze2_Description"	"그림자 마귀가 전방의 한 지점을 휩쓸어 범위 내의 적 유닛에게 피해를 줍니다."
"[english]DOTA_Tooltip_ability_custom_shadowraze2_Description"	"Shadow Fiend razes the area in front of him, dealing damage to enemy units in an area."
"DOTA_Tooltip_ability_custom_shadowraze2_shadowraze_radius"	"그림자 휩쓸기 반경:"
"[english]DOTA_Tooltip_ability_custom_shadowraze2_shadowraze_radius"	"SHADOWRAZE RADIUS:"
"DOTA_Tooltip_ability_custom_shadowraze2_shadowraze_range"	"그림자 휩쓸기 반경:"
"[english]DOTA_Tooltip_ability_custom_shadowraze2_shadowraze_range"	"SHADOWRAZE RANGE:"
"DOTA_Tooltip_ability_custom_shadowraze3"	"맞춤 그림자 휩쓸기 3"
"[english]DOTA_Tooltip_ability_custom_shadowraze3"	"Custom Shadowraze3"
"DOTA_Tooltip_ability_custom_shadowraze3_Description"	"그림자 마귀가 전방의 한 지점을 휩쓸어 범위 내의 적 유닛에게 피해를 줍니다."
"[english]DOTA_Tooltip_ability_custom_shadowraze3_Description"	"Shadow Fiend razes the area in front of him, dealing damage to enemy units in an area."
"DOTA_Tooltip_ability_custom_shadowraze3_shadowraze_radius"	"그림자 휩쓸기 반경:"
"[english]DOTA_Tooltip_ability_custom_shadowraze3_shadowraze_radius"	"SHADOWRAZE RADIUS:"
"DOTA_Tooltip_ability_custom_shadowraze3_shadowraze_range"	"그림자 휩쓸기 반경:"
"[english]DOTA_Tooltip_ability_custom_shadowraze3_shadowraze_range"	"SHADOWRAZE RANGE:"
"DOTA_Tooltip_ability_pudge_rot_lua"	"썩은 내"
"[english]DOTA_Tooltip_ability_pudge_rot_lua"	"Rot"
"DOTA_Tooltip_ability_pudge_rot_lua_Description"	"강렬한 피해를 주고 이동 속도를 느리게 하는 독성 가스를 내뿜습니다. 적은 물론 퍼지 자신도 독의 피해를 받습니다."
"[english]DOTA_Tooltip_ability_pudge_rot_lua_Description"	"A toxic cloud that deals intense damage and slows movement--harming not only enemy units but Pudge himself."
"DOTA_Tooltip_ability_pudge_rot_lua_rot_radius"	"썩은 내 반경:"
"[english]DOTA_Tooltip_ability_pudge_rot_lua_rot_radius"	"ROT RADIUS:"
"DOTA_Tooltip_ability_pudge_rot_lua_rot_tick"	"썩은 내 1회 적용:"
"[english]DOTA_Tooltip_ability_pudge_rot_lua_rot_tick"	"ROT TICK:"
"DOTA_Tooltip_ability_pudge_rot_lua_rot_slow"	"썩은 내 둔화:"
"[english]DOTA_Tooltip_ability_pudge_rot_lua_rot_slow"	"ROT SLOW:"
"DOTA_Tooltip_ability_pudge_rot_lua_rot_damage"	"썩은 내 피해:"
"[english]DOTA_Tooltip_ability_pudge_rot_lua_rot_damage"	"ROT DAMAGE:"
"DOTA_Tooltip_ability_custom_frostbite"	"동상"
"[english]DOTA_Tooltip_ability_custom_frostbite"	"Frostbite"
"DOTA_Tooltip_ability_custom_frostbite_Description"	"적 유닛 하나를 얼음 안에 가두어 이동과 공격을 막음"
"[english]DOTA_Tooltip_ability_custom_frostbite_Description"	"Encases an enemy unit in ice, prohibiting movement and attack"
"DOTA_Tooltip_ability_custom_frostbite_duration"	"영웅 지속시간:"
"[english]DOTA_Tooltip_ability_custom_frostbite_duration"	"HERO DURATION:"
"DOTA_Tooltip_ability_custom_frostbite_creep_duration"	"크립 지속시간:"
"[english]DOTA_Tooltip_ability_custom_frostbite_creep_duration"	"CREEP DURATION:"
"DOTA_Tooltip_ability_custom_pudge_meat_hook"	"고기 갈고리"
"[english]DOTA_Tooltip_ability_custom_pudge_meat_hook"	"Meat Hook"
"DOTA_Tooltip_ability_custom_pudge_meat_hook_Description"	""
"[english]DOTA_Tooltip_ability_custom_pudge_meat_hook_Description"	""
"DOTA_Tooltip_ability_custom_pudge_meat_hook_hook_distance"	"갈고리 거리:"
"[english]DOTA_Tooltip_ability_custom_pudge_meat_hook_hook_distance"	"HOOK DISTANCE:"
"DOTA_Tooltip_ability_chain_frost_lua"	"연쇄 빙결"
"[english]DOTA_Tooltip_ability_chain_frost_lua"	"Chain Frost"
"DOTA_Tooltip_ability_chain_frost_lua_Description"	""
"[english]DOTA_Tooltip_ability_chain_frost_lua_Description"	""
"DOTA_Tooltip_ability_chain_frost_lua_slow_duration"	"둔화 지속시간:"
"[english]DOTA_Tooltip_ability_chain_frost_lua_slow_duration"	"SLOW DURATION:"
"DOTA_Tooltip_ability_chain_frost_lua_slow_movement_speed"	"이동 속도 둔화:"
"[english]DOTA_Tooltip_ability_chain_frost_lua_slow_movement_speed"	"SLOW MOVEMENT SPEED:"
"DOTA_Tooltip_ability_chain_frost_lua_jump_range"	"건너뛰기 범위:"
"[english]DOTA_Tooltip_ability_chain_frost_lua_jump_range"	"JUMP RANGE:"
"DOTA_Tooltip_ability_chain_frost_lua_projectile_speed"	"투사체 속도:"
"[english]DOTA_Tooltip_ability_chain_frost_lua_projectile_speed"	"PROJECTILE SPEED:"
"DOTA_Tooltip_ability_chain_frost_lua_damage"	"피해:"
"[english]DOTA_Tooltip_ability_chain_frost_lua_damage"	"DAMAGE:"
"DOTA_Tooltip_ability_chain_frost_lua_jump_interval"	"건너뛰기 간격:"
"[english]DOTA_Tooltip_ability_chain_frost_lua_jump_interval"	"JUMP INTERVAL:"
"DOTA_Tooltip_ability_aoe_rupture_lua"	"범위 파열"
"[english]DOTA_Tooltip_ability_aoe_rupture_lua"	"Aoe Rupture"
"DOTA_Tooltip_ability_aoe_rupture_lua_Description"	"인근에 있는 모든 영웅에게 파열 시전"
"[english]DOTA_Tooltip_ability_aoe_rupture_lua_Description"	"Casts Rupture on all heroes in the vicinity"
"DOTA_Tooltip_ability_aoe_rupture_lua_movement_damage_pct"	"이동 피해 비율:"
"[english]DOTA_Tooltip_ability_aoe_rupture_lua_movement_damage_pct"	"MOVEMENT DAMAGE PCT:"
"DOTA_Tooltip_ability_aoe_rupture_lua_damage_cap_interval"	"피해 한계 간격:"
"[english]DOTA_Tooltip_ability_aoe_rupture_lua_damage_cap_interval"	"DAMAGE CAP INTERVAL:"
"DOTA_Tooltip_ability_ogreseal_flop"	"오거 바다표범 철퍽"
"[english]DOTA_Tooltip_ability_ogreseal_flop"	"Ogreseal Flop"
"DOTA_Tooltip_ability_ogreseal_flop_Description"	"철벅 철퍽 철벅 철퍽"
"[english]DOTA_Tooltip_ability_ogreseal_flop_Description"	"Flip Flop Flip Flop"
"DOTA_Tooltip_ability_ogreseal_flop_radius"	"반경:"
"[english]DOTA_Tooltip_ability_ogreseal_flop_radius"	"RADIUS:"
"DOTA_Tooltip_ability_ogreseal_flop_damage"	"피해:"
"[english]DOTA_Tooltip_ability_ogreseal_flop_damage"	"DAMAGE:"
"DOTA_Tooltip_ability_ogreseal_flop_stun_duration"	"기절 지속시간:"
"[english]DOTA_Tooltip_ability_ogreseal_flop_stun_duration"	"STUN DURATION:"
"DOTA_Tooltip_ability_shukuchi_lua"	"축지술"
"[english]DOTA_Tooltip_ability_shukuchi_lua"	"Shukuchi"
"DOTA_Tooltip_ability_shukuchi_lua_Description"	"길쌈꾼이 시야에서 사라진 다음 최대 속도로 이동할 수 있습니다."
"[english]DOTA_Tooltip_ability_shukuchi_lua_Description"	"Weaver shifts out of visibility, gaining the ability to move at maximum speed."
"DOTA_Tooltip_ability_shukuchi_lua_move_speed"	"이동 속도:"
"[english]DOTA_Tooltip_ability_shukuchi_lua_move_speed"	"MOVE SPEED:"
"DOTA_Tooltip_ability_shukuchi_lua_duration"	"지속시간:"
"[english]DOTA_Tooltip_ability_shukuchi_lua_duration"	"DURATION:"
"DOTA_Tooltip_ability_mirana_arrow_lua"	"미라나 화살"
"[english]DOTA_Tooltip_ability_mirana_arrow_lua"	"Mirana Arrow"
"DOTA_Tooltip_ability_mirana_arrow_lua_Description"	"필격의 명중률을 지닌 장거리 화살을 발사하여 가장 먼저 맞는 적에게 큰 피해를 주고 기절시킵니다. 대상을 맞히면 초기화합니다."
"[english]DOTA_Tooltip_ability_mirana_arrow_lua_Description"	"Fires a long-range arrow with deadly precision, which stuns and damages the first enemy unit it strikes. Refreshes upon hitting the target."
"DOTA_Tooltip_ability_mirana_arrow_lua_stun_duration"	"기절 지속시간:"
"[english]DOTA_Tooltip_ability_mirana_arrow_lua_stun_duration"	"STUN DURATION:"
"DOTA_Tooltip_ability_shapeshift_boar_lua"	"멧돼지 변신"
"[english]DOTA_Tooltip_ability_shapeshift_boar_lua"	"Shapeshift Boar"
"DOTA_Tooltip_ability_shapeshift_boar_lua_Description"	"보통 덩치에 원거리 유닛인 곰의 모습을 취합니다."
"[english]DOTA_Tooltip_ability_shapeshift_boar_lua_Description"	"Take the shape of a Boar, a ranged unit with medium bulk."
"DOTA_Tooltip_ability_shapeshift_boar_lua_transformation_time"	"변신 시간:"
"[english]DOTA_Tooltip_ability_shapeshift_boar_lua_transformation_time"	"TRANSFORMATION TIME:"
"DOTA_Tooltip_ability_shapeshift_bear_lua"	"곰 변신"
"[english]DOTA_Tooltip_ability_shapeshift_bear_lua"	"Shapeshift Bear"
"DOTA_Tooltip_ability_shapeshift_bear_lua_Description"	"큰 덩치에 근접 유닛인 곰의 모습을 취합니다."
"[english]DOTA_Tooltip_ability_shapeshift_bear_lua_Description"	"Take the shape of a bear, a melee unit with high bulk."
"DOTA_Tooltip_ability_shapeshift_bear_lua_transformation_time"	"변신 시간:"
"[english]DOTA_Tooltip_ability_shapeshift_bear_lua_transformation_time"	"TRANSFORMATION TIME:"
"DOTA_Tooltip_ability_shapeshift_hawk_lua"	"매 변신"
"[english]DOTA_Tooltip_ability_shapeshift_hawk_lua"	"Shapeshift Hawk"
"DOTA_Tooltip_ability_shapeshift_hawk_lua_Description"	"기동성이 뛰어나며 공격할 수 없는 유닛인 매의 형상을 취합니다."
"[english]DOTA_Tooltip_ability_shapeshift_hawk_lua_Description"	"Take the form of a hawk, a highly mobile unit with no attack."
"DOTA_Tooltip_ability_shapeshift_hawk_lua_transformation_time"	"변신 시간:"
"[english]DOTA_Tooltip_ability_shapeshift_hawk_lua_transformation_time"	"TRANSFORMATION TIME:"
"DOTA_Tooltip_ability_lion_finger_lua"	"손가락"
"[english]DOTA_Tooltip_ability_lion_finger_lua"	"Finger"
"DOTA_Tooltip_ability_lion_finger_lua_Description"	"다소 심한 방법으로라도 원숭이 왕으로 변장한 무언가의 정체를 밝혀내야 합니다. 한 방 제대로 날리면 됩니다."
"[english]DOTA_Tooltip_ability_lion_finger_lua_Description"	"Determine if something is a disguised Monkey King the hard way. By blowing it the heck up."
"DOTA_Tooltip_ability_earth_spirit_kick_lua"	"차기"
"[english]DOTA_Tooltip_ability_earth_spirit_kick_lua"	"Kick"
"DOTA_Tooltip_ability_earth_spirit_kick_lua_Description"	"공을 찹니다. 공이 벽에 맞으면 다시 튕겨 나옵니다."
"[english]DOTA_Tooltip_ability_earth_spirit_kick_lua_Description"	"Kick the ball. The ball bounces off walls."
"DOTA_Tooltip_ability_earth_spirit_kick_lua_kick_force"	"차는 힘:"
"[english]DOTA_Tooltip_ability_earth_spirit_kick_lua_kick_force"	"KICK FORCE:"
"DOTA_Tooltip_ability_drow_shoot_arrow_lua"	"화염 화살"
"[english]DOTA_Tooltip_ability_drow_shoot_arrow_lua"	"Fire Arrow"
"DOTA_Tooltip_ability_drow_shoot_arrow_lua_Description"	"지면에 화살 하나를 쏘아 맞힌 적에게 피해를 줍니다"
"[english]DOTA_Tooltip_ability_drow_shoot_arrow_lua_Description"	"Shoot an arrow at the ground, damaging enemies at the point of impact."
"DOTA_Tooltip_ability_drow_shoot_arrow_lua_damage"	"피해:"
"[english]DOTA_Tooltip_ability_drow_shoot_arrow_lua_damage"	"DAMAGE:"
"DOTA_Tooltip_ability_remote_mine_lua"	"원격 지뢰"
"[english]DOTA_Tooltip_ability_remote_mine_lua"	"Remote Mine"
"DOTA_Tooltip_ability_remote_mine_lua_Description"	"체력이 천천히 낮아지다 폭발합니다."
"[english]DOTA_Tooltip_ability_remote_mine_lua_Description"	"Slowly tick down health, and then explode."
"DOTA_Tooltip_ability_remote_mine_lua_damage"	"피해:"
"[english]DOTA_Tooltip_ability_remote_mine_lua_damage"	"DAMAGE:"
"DOTA_Tooltip_ability_remote_mine_lua_damage_radius"	"피해 반경:"
"[english]DOTA_Tooltip_ability_remote_mine_lua_damage_radius"	"DAMAGE RADIUS:"
"DOTA_Tooltip_ability_proximity_mine_lua"	"근접 지뢰"
"[english]DOTA_Tooltip_ability_proximity_mine_lua"	"Proximity Mine"
"DOTA_Tooltip_ability_proximity_mine_lua_Description"	"누군가 가까이 접근하면 폭발"
"[english]DOTA_Tooltip_ability_proximity_mine_lua_Description"	"Explode when someone comes near"
"DOTA_Tooltip_ability_proximity_mine_lua_damage"	"피해:"
"[english]DOTA_Tooltip_ability_proximity_mine_lua_damage"	"DAMAGE:"
"DOTA_Tooltip_ability_proximity_mine_lua_activation_radius"	"활성화 반경:"
"[english]DOTA_Tooltip_ability_proximity_mine_lua_activation_radius"	"ACTIVATION RADIUS:"
"DOTA_Tooltip_ability_proximity_mine_lua_damage_radius"	"피해 반경:"
"[english]DOTA_Tooltip_ability_proximity_mine_lua_damage_radius"	"DAMAGE RADIUS:"
"DOTA_Tooltip_ability_stasis_trap_lua"	"정지 덫"
"[english]DOTA_Tooltip_ability_stasis_trap_lua"	"Stasis Trap"
"DOTA_Tooltip_ability_stasis_trap_lua_Description"	"발동 시 근처에 있는 유닛을 기절시킵니다."
"[english]DOTA_Tooltip_ability_stasis_trap_lua_Description"	"Stuns nearby units when triggered."
"DOTA_Tooltip_ability_stasis_trap_lua_stun_duration"	"기절 지속시간:"
"[english]DOTA_Tooltip_ability_stasis_trap_lua_stun_duration"	"STUN DURATION:"
"DOTA_Tooltip_ability_stasis_trap_lua_activation_radius"	"활성화 반경:"
"[english]DOTA_Tooltip_ability_stasis_trap_lua_activation_radius"	"ACTIVATION RADIUS:"
"DOTA_Tooltip_ability_stasis_trap_lua_stun_radius"	"기절 반경:"
"[english]DOTA_Tooltip_ability_stasis_trap_lua_stun_radius"	"STUN RADIUS:"
"DOTA_Tooltip_ability_lightning_bolt_lua"	"번갯불"
"[english]DOTA_Tooltip_ability_lightning_bolt_lua"	"Lightning Bolt"
"DOTA_Tooltip_ability_lightning_bolt_lua_Description"	"짧은 시간 동안 일정 지역에 진실의 시야를 얻습니다."
"[english]DOTA_Tooltip_ability_lightning_bolt_lua_Description"	"Gain true sight in an area for a short period of tiem."
"DOTA_Tooltip_ability_lightning_bolt_lua_true_sight_radius"	"진실의 시야 반경:"
"[english]DOTA_Tooltip_ability_lightning_bolt_lua_true_sight_radius"	"TRUE SIGHT RADIUS:"
"DOTA_Tooltip_ability_lightning_bolt_lua_true_sight_duration"	"진실의 시야 지속시간:"
"[english]DOTA_Tooltip_ability_lightning_bolt_lua_true_sight_duration"	"TRUE SIGHT DURATION:"
"DOTA_Tooltip_ability_heartstopper_aura_lua"	"심장마비의 오라"
"[english]DOTA_Tooltip_ability_heartstopper_aura_lua"	"Heartstopper Aura"
"DOTA_Tooltip_ability_heartstopper_aura_lua_Description"	"강령사제가 주위 적의 심장을 마비시켜 지속 피해를 줍니다."
"[english]DOTA_Tooltip_ability_heartstopper_aura_lua_Description"	"Necrophos stills the hearts of his opponents, causing nearby enemy units to take damage over time."
"DOTA_Tooltip_ability_heartstopper_aura_lua_damage_per_tick"	"적용 1회당 피해:"
"[english]DOTA_Tooltip_ability_heartstopper_aura_lua_damage_per_tick"	"DAMAGE PER TICK:"
"DOTA_Tooltip_ability_heartstopper_aura_lua_tick_rate"	"적용 1회당 비율:"
"[english]DOTA_Tooltip_ability_heartstopper_aura_lua_tick_rate"	"TICK RATE:"
"DOTA_Tooltip_ability_custom_shredder_whirling_death"	"벌목꾼 죽음의 회전날"
"[english]DOTA_Tooltip_ability_custom_shredder_whirling_death"	"Shredder Whirling Death"
"DOTA_Tooltip_ability_custom_shredder_whirling_death_Description"	""
"[english]DOTA_Tooltip_ability_custom_shredder_whirling_death_Description"	""
"DOTA_Tooltip_ability_custom_shredder_whirling_death_whirling_radius"	"회전날 반경:"
"[english]DOTA_Tooltip_ability_custom_shredder_whirling_death_whirling_radius"	"WHIRLING RADIUS:"
"DOTA_Tooltip_ability_custom_shredder_whirling_death_whirling_damage"	"회전날 피해:"
"[english]DOTA_Tooltip_ability_custom_shredder_whirling_death_whirling_damage"	"WHIRLING DAMAGE:"
"DOTA_Tooltip_ability_custom_shredder_whirling_death_whirling_tick"	"회전날 1회 적용:"
"[english]DOTA_Tooltip_ability_custom_shredder_whirling_death_whirling_tick"	"WHIRLING TICK:"
"DOTA_Tooltip_ability_custom_shredder_whirling_death_stat_loss_pct"	"능력치 상실 백분율:"
"[english]DOTA_Tooltip_ability_custom_shredder_whirling_death_stat_loss_pct"	"STAT LOSS PCT:"
"DOTA_Tooltip_ability_custom_shredder_whirling_death_LinkedSpecialBonus"	"연결된 특별 보너스:"
"[english]DOTA_Tooltip_ability_custom_shredder_whirling_death_LinkedSpecialBonus"	"LINKEDSPECIALBONUS:"
"DOTA_Tooltip_ability_custom_shredder_whirling_death_duration"	"지속시간:"
"[english]DOTA_Tooltip_ability_custom_shredder_whirling_death_duration"	"DURATION:"
"DOTA_Tooltip_ability_custom_shredder_timber_chain"	"벌목꾼 사슬 던지기"
"[english]DOTA_Tooltip_ability_custom_shredder_timber_chain"	"Shredder Timber Chain"
"DOTA_Tooltip_ability_custom_shredder_timber_chain_Description"	""
"[english]DOTA_Tooltip_ability_custom_shredder_timber_chain_Description"	""
"DOTA_Tooltip_ability_custom_shredder_timber_chain_chain_radius"	"연쇄 반경:"
"[english]DOTA_Tooltip_ability_custom_shredder_timber_chain_chain_radius"	"CHAIN RADIUS:"
"DOTA_Tooltip_ability_custom_shredder_timber_chain_range"	"범위:"
"[english]DOTA_Tooltip_ability_custom_shredder_timber_chain_range"	"RANGE:"
"DOTA_Tooltip_ability_custom_shredder_timber_chain_radius"	"반경:"
"[english]DOTA_Tooltip_ability_custom_shredder_timber_chain_radius"	"RADIUS:"
"DOTA_Tooltip_ability_custom_shredder_timber_chain_speed"	"속도:"
"[english]DOTA_Tooltip_ability_custom_shredder_timber_chain_speed"	"SPEED:"
"DOTA_Tooltip_ability_custom_shredder_timber_chain_damage"	"피해:"
"[english]DOTA_Tooltip_ability_custom_shredder_timber_chain_damage"	"DAMAGE:"
"DOTA_Tooltip_ability_custom_shredder_chakram"	"벌목꾼 차크람"
"[english]DOTA_Tooltip_ability_custom_shredder_chakram"	"Shredder Chakram"
"DOTA_Tooltip_ability_custom_shredder_chakram_Description"	""
"[english]DOTA_Tooltip_ability_custom_shredder_chakram_Description"	""
"DOTA_Tooltip_ability_custom_shredder_chakram_speed"	"속도:"
"[english]DOTA_Tooltip_ability_custom_shredder_chakram_speed"	"SPEED:"
"DOTA_Tooltip_ability_custom_shredder_chakram_radius"	"반경:"
"[english]DOTA_Tooltip_ability_custom_shredder_chakram_radius"	"RADIUS:"
"DOTA_Tooltip_ability_custom_shredder_chakram_pass_damage"	"이동 중 피해:"
"[english]DOTA_Tooltip_ability_custom_shredder_chakram_pass_damage"	"PASS DAMAGE:"
"DOTA_Tooltip_ability_custom_shredder_chakram_damage_per_second"	"초당 피해:"
"[english]DOTA_Tooltip_ability_custom_shredder_chakram_damage_per_second"	"DAMAGE PER SECOND:"
"DOTA_Tooltip_ability_custom_shredder_chakram_slow"	"둔화:"
"[english]DOTA_Tooltip_ability_custom_shredder_chakram_slow"	"SLOW:"
"DOTA_Tooltip_ability_custom_shredder_chakram_damage_interval"	"피해 간격:"
"[english]DOTA_Tooltip_ability_custom_shredder_chakram_damage_interval"	"DAMAGE INTERVAL:"
"DOTA_Tooltip_ability_custom_shredder_chakram_break_distance"	"단절 거리:"
"[english]DOTA_Tooltip_ability_custom_shredder_chakram_break_distance"	"BREAK DISTANCE:"
"DOTA_Tooltip_ability_custom_shredder_chakram_mana_per_second"	"초당 마나:"
"[english]DOTA_Tooltip_ability_custom_shredder_chakram_mana_per_second"	"MANA PER SECOND:"
"DOTA_Tooltip_ability_custom_shredder_chakram_pass_slow_duration"	"이동 중 둔화 지속시간:"
"[english]DOTA_Tooltip_ability_custom_shredder_chakram_pass_slow_duration"	"PASS SLOW DURATION:"
"DOTA_Tooltip_ability_custom_nether_swap"	"황천의 이동술"
"[english]DOTA_Tooltip_ability_custom_nether_swap"	"Nether Swap"
"DOTA_Tooltip_ability_custom_nether_swap_Description"	"대상과 위치를 바꿉니다."
"[english]DOTA_Tooltip_ability_custom_nether_swap_Description"	"Swap places with the target."
"DOTA_Tooltip_ability_custom_nether_swap_tooltip_range"	"툴팁 범위:"
"[english]DOTA_Tooltip_ability_custom_nether_swap_tooltip_range"	"TOOLTIP RANGE:"
"DOTA_Tooltip_ability_custom_nether_swap_nether_swap_cooldown_scepter"	"홀 장착 시 황천의 이동술 쿨다운:"
"[english]DOTA_Tooltip_ability_custom_nether_swap_nether_swap_cooldown_scepter"	"NETHER SWAP COOLDOWN SCEPTER:"
"DOTA_Tooltip_ability_custom_nether_swap_illusion_damage_out_pct_scepter"	"홀 장착 시 환영이 주는 피해 비율:"
"[english]DOTA_Tooltip_ability_custom_nether_swap_illusion_damage_out_pct_scepter"	"ILLUSION DAMAGE OUT PCT SCEPTER:"
"DOTA_Tooltip_ability_custom_nether_swap_illusion_damage_in_pct_scepter"	"홀 장착 시 환영이 받는 피해 비율:"
"[english]DOTA_Tooltip_ability_custom_nether_swap_illusion_damage_in_pct_scepter"	"ILLUSION DAMAGE IN PCT SCEPTER:"
"DOTA_Tooltip_ability_custom_puck_phase_shift"	"맞춤 퍽 위상 전이"
"[english]DOTA_Tooltip_ability_custom_puck_phase_shift"	"Custom Puck Phase Shift"
"DOTA_Tooltip_ability_custom_puck_phase_shift_Description"	"퍽이 외부의 공격으로부터 어떤 피해도 받지 않는 다른 차원으로 잠시 몸을 숨깁니다."
"[english]DOTA_Tooltip_ability_custom_puck_phase_shift_Description"	"Puck briefly shifts into another dimension where it is immune from harm."
"DOTA_Tooltip_ability_custom_puck_phase_shift_duration"	"지속시간:"
"[english]DOTA_Tooltip_ability_custom_puck_phase_shift_duration"	"DURATION:"
"DOTA_Tooltip_ability_ogre_tank_melee_smash"	"강타"
"[english]DOTA_Tooltip_ability_ogre_tank_melee_smash"	"Smash"
"DOTA_Tooltip_ability_ogre_tank_melee_smash_Description"	"가아아앙타"
"[english]DOTA_Tooltip_ability_ogre_tank_melee_smash_Description"	"SMAAAAASH"
"DOTA_Tooltip_ability_ogre_tank_melee_smash_impact_radius"	"충격 반경:"
"[english]DOTA_Tooltip_ability_ogre_tank_melee_smash_impact_radius"	"IMPACT RADIUS:"
"DOTA_Tooltip_ability_ogre_tank_melee_smash_stun_duration"	"기절 지속시간:"
"[english]DOTA_Tooltip_ability_ogre_tank_melee_smash_stun_duration"	"STUN DURATION:"
"DOTA_Tooltip_ability_ogre_tank_melee_smash_damage"	"피해:"
"[english]DOTA_Tooltip_ability_ogre_tank_melee_smash_damage"	"DAMAGE:"
"DOTA_Tooltip_ability_ogre_tank_melee_smash_base_swing_speed"	"기본 휘두르기 속도:"
"[english]DOTA_Tooltip_ability_ogre_tank_melee_smash_base_swing_speed"	"BASE SWING SPEED:"
"DOTA_Tooltip_ability_ogre_tank_jump_smash"	"도약 강타"
"[english]DOTA_Tooltip_ability_ogre_tank_jump_smash"	"Jump Smash"
"DOTA_Tooltip_ability_ogre_tank_jump_smash_Description"	"도오오오오약"
"[english]DOTA_Tooltip_ability_ogre_tank_jump_smash_Description"	"JUUUUUUUUMP"
"DOTA_Tooltip_ability_ogre_tank_jump_smash_impact_radius"	"충격 반경:"
"[english]DOTA_Tooltip_ability_ogre_tank_jump_smash_impact_radius"	"IMPACT RADIUS:"
"DOTA_Tooltip_ability_ogre_tank_jump_smash_stun_duration"	"기절 지속시간:"
"[english]DOTA_Tooltip_ability_ogre_tank_jump_smash_stun_duration"	"STUN DURATION:"
"DOTA_Tooltip_ability_ogre_tank_jump_smash_damage"	"피해:"
"[english]DOTA_Tooltip_ability_ogre_tank_jump_smash_damage"	"DAMAGE:"
"DOTA_Tooltip_ability_ogre_tank_jump_smash_jump_speed"	"도약 속도:"
"[english]DOTA_Tooltip_ability_ogre_tank_jump_smash_jump_speed"	"JUMP SPEED:"
"DOTA_Tooltip_ability_ogre_tank_boss_melee_smash"	"강타"
"[english]DOTA_Tooltip_ability_ogre_tank_boss_melee_smash"	"Smash"
"DOTA_Tooltip_ability_ogre_tank_boss_melee_smash_Description"	"가아아아아아아아아아아아앙타"
"[english]DOTA_Tooltip_ability_ogre_tank_boss_melee_smash_Description"	"SMAAAAAAAAAAAAAAAAAAAAASH"
"DOTA_Tooltip_ability_ogre_tank_boss_melee_smash_impact_radius"	"충격 반경:"
"[english]DOTA_Tooltip_ability_ogre_tank_boss_melee_smash_impact_radius"	"IMPACT RADIUS:"
"DOTA_Tooltip_ability_ogre_tank_boss_melee_smash_stun_duration"	"기절 지속시간:"
"[english]DOTA_Tooltip_ability_ogre_tank_boss_melee_smash_stun_duration"	"STUN DURATION:"
"DOTA_Tooltip_ability_ogre_tank_boss_melee_smash_damage"	"피해:"
"[english]DOTA_Tooltip_ability_ogre_tank_boss_melee_smash_damage"	"DAMAGE:"
"DOTA_Tooltip_ability_ogre_tank_boss_melee_smash_base_swing_speed"	"기본 휘두르기 속도:"
"[english]DOTA_Tooltip_ability_ogre_tank_boss_melee_smash_base_swing_speed"	"BASE SWING SPEED:"
"DOTA_Tooltip_ability_ogre_tank_boss_jump_smash"	"도약 강타"
"[english]DOTA_Tooltip_ability_ogre_tank_boss_jump_smash"	"Jump Smash"
"DOTA_Tooltip_ability_ogre_tank_boss_jump_smash_Description"	"도오오오오오오오오오오오오오약"
"[english]DOTA_Tooltip_ability_ogre_tank_boss_jump_smash_Description"	"JUUUUUUUUUUUUUUUUUUUUUUUUUMP"
"DOTA_Tooltip_ability_ogre_tank_boss_jump_smash_impact_radius"	"충격 반경:"
"[english]DOTA_Tooltip_ability_ogre_tank_boss_jump_smash_impact_radius"	"IMPACT RADIUS:"
"DOTA_Tooltip_ability_ogre_tank_boss_jump_smash_stun_duration"	"기절 지속시간:"
"[english]DOTA_Tooltip_ability_ogre_tank_boss_jump_smash_stun_duration"	"STUN DURATION:"
"DOTA_Tooltip_ability_ogre_tank_boss_jump_smash_damage"	"피해:"
"[english]DOTA_Tooltip_ability_ogre_tank_boss_jump_smash_damage"	"DAMAGE:"
"DOTA_Tooltip_ability_ogre_tank_boss_jump_smash_jump_speed"	"도약 속도:"
"[english]DOTA_Tooltip_ability_ogre_tank_boss_jump_smash_jump_speed"	"JUMP SPEED:"
"DOTA_Tooltip_ability_conjure_image_lua"	"환영 창조"
"[english]DOTA_Tooltip_ability_conjure_image_lua"	"Conjure Image"
"DOTA_Tooltip_ability_conjure_image_lua_Description"	""
"[english]DOTA_Tooltip_ability_conjure_image_lua_Description"	""
"DOTA_Tooltip_ability_conjure_image_lua_illusion_duration"	"환영 지속시간:"
"[english]DOTA_Tooltip_ability_conjure_image_lua_illusion_duration"	"ILLUSION DURATION:"
"DOTA_Tooltip_ability_conjure_image_lua_illusion_incoming_damage"	"환영 받는 피해:"
"[english]DOTA_Tooltip_ability_conjure_image_lua_illusion_incoming_damage"	"ILLUSION INCOMING DAMAGE:"
"DOTA_Tooltip_ability_race_charge_lua"	"돌진"
"[english]DOTA_Tooltip_ability_race_charge_lua"	"Charge"
"DOTA_Tooltip_ability_race_charge_lua_Description"	""
"[english]DOTA_Tooltip_ability_race_charge_lua_Description"	""
"DOTA_Tooltip_ability_race_charge_lua_distance"	"거리:"
"[english]DOTA_Tooltip_ability_race_charge_lua_distance"	"DISTANCE:"
"DOTA_Tooltip_ability_invoker_quas_lua"	"콰스"
"[english]DOTA_Tooltip_ability_invoker_quas_lua"	"Quas"
"DOTA_Tooltip_ability_invoker_quas_lua_Description"	""
"[english]DOTA_Tooltip_ability_invoker_quas_lua_Description"	""
"DOTA_Tooltip_ability_invoker_wex_lua"	"웩스"
"[english]DOTA_Tooltip_ability_invoker_wex_lua"	"Wex"
"DOTA_Tooltip_ability_invoker_wex_lua_Description"	""
"[english]DOTA_Tooltip_ability_invoker_wex_lua_Description"	""
"DOTA_Tooltip_ability_invoker_exort_lua"	"익조트"
"[english]DOTA_Tooltip_ability_invoker_exort_lua"	"Exort"
"DOTA_Tooltip_ability_invoker_exort_lua_Description"	""
"[english]DOTA_Tooltip_ability_invoker_exort_lua_Description"	""
"DOTA_Tooltip_ability_invoker_invoke_lua"	"원소 조합"
"[english]DOTA_Tooltip_ability_invoker_invoke_lua"	"Invoke"
"DOTA_Tooltip_ability_invoker_invoke_lua_Description"	""
"[english]DOTA_Tooltip_ability_invoker_invoke_lua_Description"	""
"DOTA_Tooltip_ability_cold_snap_passive"	"한파"
"[english]DOTA_Tooltip_ability_cold_snap_passive"	"Cold Snap"
"DOTA_Tooltip_ability_cold_snap_passive_Description"	""
"[english]DOTA_Tooltip_ability_cold_snap_passive_Description"	""
"DOTA_Tooltip_ability_ghost_walk_passive"	"유령 보행"
"[english]DOTA_Tooltip_ability_ghost_walk_passive"	"Ghost Walk"
"DOTA_Tooltip_ability_ghost_walk_passive_Description"	""
"[english]DOTA_Tooltip_ability_ghost_walk_passive_Description"	""
"DOTA_Tooltip_ability_ice_wall_passive"	"얼음 장벽"
"[english]DOTA_Tooltip_ability_ice_wall_passive"	"Ice Wall"
"DOTA_Tooltip_ability_ice_wall_passive_Description"	""
"[english]DOTA_Tooltip_ability_ice_wall_passive_Description"	""
"DOTA_Tooltip_ability_deafening_blast_passive"	"굉음 폭발"
"[english]DOTA_Tooltip_ability_deafening_blast_passive"	"Deafening Blast"
"DOTA_Tooltip_ability_deafening_blast_passive_Description"	""
"[english]DOTA_Tooltip_ability_deafening_blast_passive_Description"	""
"DOTA_Tooltip_ability_emp_passive"	"전자기파"
"[english]DOTA_Tooltip_ability_emp_passive"	"Emp"
"DOTA_Tooltip_ability_emp_passive_Description"	""
"[english]DOTA_Tooltip_ability_emp_passive_Description"	""
"DOTA_Tooltip_ability_tornado_passive"	"회오리"
"[english]DOTA_Tooltip_ability_tornado_passive"	"Tornado"
"DOTA_Tooltip_ability_tornado_passive_Description"	""
"[english]DOTA_Tooltip_ability_tornado_passive_Description"	""
"DOTA_Tooltip_ability_chaos_meteor_passive"	"혼돈의 유성"
"[english]DOTA_Tooltip_ability_chaos_meteor_passive"	"Chaos Meteor"
"DOTA_Tooltip_ability_chaos_meteor_passive_Description"	""
"[english]DOTA_Tooltip_ability_chaos_meteor_passive_Description"	""
"DOTA_Tooltip_ability_sunstrike_passive"	"태양 강타"
"[english]DOTA_Tooltip_ability_sunstrike_passive"	"Sunstrike"
"DOTA_Tooltip_ability_sunstrike_passive_Description"	""
"[english]DOTA_Tooltip_ability_sunstrike_passive_Description"	""
"DOTA_Tooltip_ability_forge_spirit_passive"	"달구어진 영혼"
"[english]DOTA_Tooltip_ability_forge_spirit_passive"	"Forge Spirit"
"DOTA_Tooltip_ability_forge_spirit_passive_Description"	""
"[english]DOTA_Tooltip_ability_forge_spirit_passive_Description"	""
"DOTA_Tooltip_ability_alacrity_passive"	"활력"
"[english]DOTA_Tooltip_ability_alacrity_passive"	"Alacrity"
"DOTA_Tooltip_ability_alacrity_passive_Description"	""
"[english]DOTA_Tooltip_ability_alacrity_passive_Description"	""
"DOTA_Tooltip_ability_invoker_leader_tornado"	"회오리"
"[english]DOTA_Tooltip_ability_invoker_leader_tornado"	"Tornado"
"DOTA_Tooltip_ability_invoker_leader_tornado_Description"	""
"[english]DOTA_Tooltip_ability_invoker_leader_tornado_Description"	""
"DOTA_Tooltip_ability_invoker_leader_deafening_blast"	"굉음 폭발"
"[english]DOTA_Tooltip_ability_invoker_leader_deafening_blast"	"Deafening Blast"
"DOTA_Tooltip_ability_invoker_leader_deafening_blast_Description"	""
"[english]DOTA_Tooltip_ability_invoker_leader_deafening_blast_Description"	""
"DOTA_Tooltip_ability_invoker_leader_sunstrike"	"태양 강타"
"[english]DOTA_Tooltip_ability_invoker_leader_sunstrike"	"Sunstrike"
"DOTA_Tooltip_ability_invoker_leader_sunstrike_Description"	""
"[english]DOTA_Tooltip_ability_invoker_leader_sunstrike_Description"	""
"DOTA_Tooltip_ability_invoker_leader_sunstrike_delay"	"지연시간:"
"[english]DOTA_Tooltip_ability_invoker_leader_sunstrike_delay"	"DELAY:"
"DOTA_Tooltip_ability_invoker_leader_sunstrike_area_of_effect"	"효과 범위:"
"[english]DOTA_Tooltip_ability_invoker_leader_sunstrike_area_of_effect"	"AREA OF EFFECT:"
"DOTA_Tooltip_ability_invoker_leader_chaos_meteor"	"원소술사 지도자 혼돈의 유성"
"[english]DOTA_Tooltip_ability_invoker_leader_chaos_meteor"	"Invoker Leader Chaos Meteor"
"DOTA_Tooltip_ability_invoker_leader_chaos_meteor_Description"	""
"[english]DOTA_Tooltip_ability_invoker_leader_chaos_meteor_Description"	""
"DOTA_Tooltip_ability_invoker_leader_ice_wall"	"얼음 장벽"
"[english]DOTA_Tooltip_ability_invoker_leader_ice_wall"	"Ice Wall"
"DOTA_Tooltip_ability_invoker_leader_ice_wall_Description"	""
"[english]DOTA_Tooltip_ability_invoker_leader_ice_wall_Description"	""
"DOTA_Tooltip_ability_invoker_leader_ice_wall_duration"	"지속시간:"
"[english]DOTA_Tooltip_ability_invoker_leader_ice_wall_duration"	"DURATION:"
"DOTA_Tooltip_ability_invoker_leader_emp"	"전자기파"
"[english]DOTA_Tooltip_ability_invoker_leader_emp"	"Emp"
"DOTA_Tooltip_ability_invoker_leader_emp_Description"	""
"[english]DOTA_Tooltip_ability_invoker_leader_emp_Description"	""
"DOTA_Tooltip_ability_invoker_leader_emp_delay"	"지연시간:"
"[english]DOTA_Tooltip_ability_invoker_leader_emp_delay"	"DELAY:"
"DOTA_Tooltip_ability_invoker_leader_emp_area_of_effect"	"효과 범위:"
"[english]DOTA_Tooltip_ability_invoker_leader_emp_area_of_effect"	"AREA OF EFFECT:"
"DOTA_Tooltip_ability_invoker_leader_alacrity"	"활력"
"[english]DOTA_Tooltip_ability_invoker_leader_alacrity"	"Alacrity"
"DOTA_Tooltip_ability_invoker_leader_alacrity_Description"	""
"[english]DOTA_Tooltip_ability_invoker_leader_alacrity_Description"	""
"DOTA_Tooltip_ability_invoker_leader_alacrity_bonus_attack_speed"	"보너스 공격 속도:"
"[english]DOTA_Tooltip_ability_invoker_leader_alacrity_bonus_attack_speed"	"BONUS ATTACK SPEED:"
"DOTA_Tooltip_ability_invoker_leader_alacrity_bonus_damage"	"보너스 피해:"
"[english]DOTA_Tooltip_ability_invoker_leader_alacrity_bonus_damage"	"BONUS DAMAGE:"
"DOTA_Tooltip_ability_invoker_leader_alacrity_duration"	"지속시간:"
"[english]DOTA_Tooltip_ability_invoker_leader_alacrity_duration"	"DURATION:"
"DOTA_Tooltip_ability_invoker_leader_forge_spirit"	"달구어진 영혼"
"[english]DOTA_Tooltip_ability_invoker_leader_forge_spirit"	"Forge Spirit"
"DOTA_Tooltip_ability_invoker_leader_forge_spirit_Description"	""
"[english]DOTA_Tooltip_ability_invoker_leader_forge_spirit_Description"	""
"DOTA_Tooltip_ability_invoker_leader_forge_spirit_duration"	"지속시간:"
"[english]DOTA_Tooltip_ability_invoker_leader_forge_spirit_duration"	"DURATION:"
"DOTA_Tooltip_ability_invoker_leader_cold_snap"	"한파"
"[english]DOTA_Tooltip_ability_invoker_leader_cold_snap"	"Cold Snap"
"DOTA_Tooltip_ability_invoker_leader_cold_snap_Description"	""
"[english]DOTA_Tooltip_ability_invoker_leader_cold_snap_Description"	""
"DOTA_Tooltip_ability_invoker_leader_cold_snap_duration"	"지속시간:"
"[english]DOTA_Tooltip_ability_invoker_leader_cold_snap_duration"	"DURATION:"
"DOTA_Tooltip_ability_invoker_leader_invoke"	"원소 조합"
"[english]DOTA_Tooltip_ability_invoker_leader_invoke"	"Invoke"
"DOTA_Tooltip_ability_invoker_leader_invoke_Description"	""
"[english]DOTA_Tooltip_ability_invoker_leader_invoke_Description"	""
"DOTA_Tooltip_ability_tombstone_spawn_zombies_lua"	"좀비 생성"
"[english]DOTA_Tooltip_ability_tombstone_spawn_zombies_lua"	"Spawn Zombies"
"DOTA_Tooltip_ability_tombstone_spawn_zombies_lua_Description"	""
"[english]DOTA_Tooltip_ability_tombstone_spawn_zombies_lua_Description"	""
"DOTA_Tooltip_ability_tombstone_spawn_zombies_lua_spawn_delay"	"생성 지연시간:"
"[english]DOTA_Tooltip_ability_tombstone_spawn_zombies_lua_spawn_delay"	"SPAWN DELAY:"
"DOTA_Tooltip_ability_tombstone_spawn_zombies_lua_num_to_spawn"	"생성 숫자:"
"[english]DOTA_Tooltip_ability_tombstone_spawn_zombies_lua_num_to_spawn"	"NUM TO SPAWN:"
"DOTA_Tooltip_ability_tombstone_spawn_zombies_lua_max_spawned"	"최대 생성:"
"[english]DOTA_Tooltip_ability_tombstone_spawn_zombies_lua_max_spawned"	"MAX SPAWNED:"
"DOTA_Tooltip_ability_sniper_ground_shot_lua"	"지상 사격"
"[english]DOTA_Tooltip_ability_sniper_ground_shot_lua"	"Ground Shot"
"DOTA_Tooltip_ability_sniper_ground_shot_lua_Description"	"적을 관통하며 큰 피해를 주는 탄환을 발사합니다."
"[english]DOTA_Tooltip_ability_sniper_ground_shot_lua_Description"	"Fires a bullet that pierces through enemies, dealing high damage"
"DOTA_Tooltip_ability_sniper_ground_shot_lua_damage"	"피해:"
"[english]DOTA_Tooltip_ability_sniper_ground_shot_lua_damage"	"DAMAGE:"
"DOTA_Tooltip_ability_furion_teleport_lua"	"순간이동"
"[english]DOTA_Tooltip_ability_furion_teleport_lua"	"Teleport"
"DOTA_Tooltip_ability_furion_teleport_lua_Description"	"투기장 안 어느 곳으로든 순간이동합니다."
"[english]DOTA_Tooltip_ability_furion_teleport_lua_Description"	"Teleports to any point in the arena."
"DOTA_Tooltip_ability_greater_bash_lua"	"혼신의 강타"
"[english]DOTA_Tooltip_ability_greater_bash_lua"	"Greater Bash"
"DOTA_Tooltip_ability_greater_bash_lua_Description"	""
"[english]DOTA_Tooltip_ability_greater_bash_lua_Description"	""
"DOTA_Tooltip_ability_greater_bash_lua_damage"	"피해:"
"[english]DOTA_Tooltip_ability_greater_bash_lua_damage"	"DAMAGE:"
"DOTA_Tooltip_ability_greater_bash_lua_knockback_distance"	"밀치기 거리:"
"[english]DOTA_Tooltip_ability_greater_bash_lua_knockback_distance"	"KNOCKBACK DISTANCE:"
"DOTA_Tooltip_ability_arcane_bolt_lua"	"신비의 광선"
"[english]DOTA_Tooltip_ability_arcane_bolt_lua"	"Arcane Bolt"
"DOTA_Tooltip_ability_arcane_bolt_lua_Description"	"대상을 따라가 마법 피해를 주는 화살을 발사합니다."
"[english]DOTA_Tooltip_ability_arcane_bolt_lua_Description"	"Fires a bolt of magical damage that follows its target."
"DOTA_Tooltip_ability_arcane_bolt_lua_damage"	"피해:"
"[english]DOTA_Tooltip_ability_arcane_bolt_lua_damage"	"DAMAGE:"
"DOTA_Tooltip_ability_custom_boar_poison"	"독"
"[english]DOTA_Tooltip_ability_custom_boar_poison"	"Poison"
"DOTA_Tooltip_ability_custom_boar_poison_Description"	""
"[english]DOTA_Tooltip_ability_custom_boar_poison_Description"	""
"DOTA_Tooltip_ability_custom_boar_poison_attack_speed"	"공격 속도:"
"[english]DOTA_Tooltip_ability_custom_boar_poison_attack_speed"	"ATTACK SPEED:"
"DOTA_Tooltip_ability_custom_boar_poison_movement_speed"	"이동 속도:"
"[english]DOTA_Tooltip_ability_custom_boar_poison_movement_speed"	"MOVEMENT SPEED:"
"DOTA_Tooltip_ability_custom_boar_poison_duration"	"지속시간:"
"[english]DOTA_Tooltip_ability_custom_boar_poison_duration"	"DURATION:"
"DOTA_Tooltip_ability_lone_druid_rabid_lua"	"광증"
"[english]DOTA_Tooltip_ability_lone_druid_rabid_lua"	"Rabid"
"DOTA_Tooltip_ability_lone_druid_rabid_lua_Description"	"공격력과 방어력이 증가하며 짧은 시간 동안 마법에 면역이 됩니다."
"[english]DOTA_Tooltip_ability_lone_druid_rabid_lua_Description"	"Adds attack damage and armor, and also becomes magic immune for a short duration."
"DOTA_Tooltip_ability_lone_druid_rabid_lua_bonus_move_speed"	"보너스 이동 속도:"
"[english]DOTA_Tooltip_ability_lone_druid_rabid_lua_bonus_move_speed"	"BONUS MOVE SPEED:"
"DOTA_Tooltip_ability_lone_druid_rabid_lua_bonus_attack_speed"	"보너스 공격 속도:"
"[english]DOTA_Tooltip_ability_lone_druid_rabid_lua_bonus_attack_speed"	"BONUS ATTACK SPEED:"
"DOTA_Tooltip_ability_lone_druid_rabid_lua_duration"	"지속시간:"
"[english]DOTA_Tooltip_ability_lone_druid_rabid_lua_duration"	"DURATION:"
"DOTA_Tooltip_ability_custom_entangling_roots"	"휘감는 뿌리"
"[english]DOTA_Tooltip_ability_custom_entangling_roots"	"Entangling Roots"
"DOTA_Tooltip_ability_custom_entangling_roots_Description"	"공격 시 일정 확률로 땅에서 뿌리를 불러내어 적을 움직이지 못하게 하고 매초 피해를 줍니다."
"[english]DOTA_Tooltip_ability_custom_entangling_roots_Description"	"Attacks have a chance to cause roots to burst from the ground, immobilizing the attacked enemy unit, and dealing damage per second."
"DOTA_Tooltip_ability_custom_entangling_roots_entangle_chance"	"휘감기 확률:"
"[english]DOTA_Tooltip_ability_custom_entangling_roots_entangle_chance"	"ENTANGLE CHANCE:"
"DOTA_Tooltip_ability_custom_entangling_roots_hero_duration"	"지속시간:"
"[english]DOTA_Tooltip_ability_custom_entangling_roots_hero_duration"	"DURATION:"
"DOTA_Tooltip_ability_place_land_mine_lua"	"지뢰 설치"
"[english]DOTA_Tooltip_ability_place_land_mine_lua"	"Place Land Mine Lua"
"DOTA_Tooltip_ability_place_land_mine_lua_Description"	"적과 접촉하면 폭발하는 지뢰 한 개를 설치합니다."
"[english]DOTA_Tooltip_ability_place_land_mine_lua_Description"	"Place a Land Mine that explodes upon contact with an enemy."
"DOTA_Tooltip_ability_place_land_mine_lua_damage"	"피해:"
"[english]DOTA_Tooltip_ability_place_land_mine_lua_damage"	"DAMAGE:"
"DOTA_Tooltip_ability_place_land_mine_lua_activation_radius"	"활성화 반경:"
"[english]DOTA_Tooltip_ability_place_land_mine_lua_activation_radius"	"ACTIVATION RADIUS:"
"DOTA_Tooltip_ability_place_land_mine_lua_damage_radius"	"피해 반경:"
"[english]DOTA_Tooltip_ability_place_land_mine_lua_damage_radius"	"DAMAGE RADIUS:"
"DOTA_Tooltip_ability_custom_overpower"	"제압"
"[english]DOTA_Tooltip_ability_custom_overpower"	"Overpower"
"DOTA_Tooltip_ability_custom_overpower_Description"	"우르사가 숙련된 싸움 기술을 발휘하여 일정한 횟수 만큼 연속하여 공격하는 동안 공격 속도를 높입니다."
"[english]DOTA_Tooltip_ability_custom_overpower_Description"	"Using his skill in combat, Ursa gains increased attack speed for a number of subsequent attacks."
"DOTA_Tooltip_ability_custom_overpower_max_attacks"	"최대 공격:"
"[english]DOTA_Tooltip_ability_custom_overpower_max_attacks"	"MAX ATTACKS:"
"DOTA_Tooltip_ability_custom_overpower_attack_speed_bonus_pct"	"공격 속도 보너스 비율:"
"[english]DOTA_Tooltip_ability_custom_overpower_attack_speed_bonus_pct"	"ATTACK SPEED BONUS PCT:"
"DOTA_Tooltip_ability_custom_overpower_duration_tooltip"	"지속시간:"
"[english]DOTA_Tooltip_ability_custom_overpower_duration_tooltip"	"DURATION:"
"DOTA_Tooltip_ability_custom_fury_swipes"	"분노의 발톱"
"[english]DOTA_Tooltip_ability_custom_fury_swipes"	"Fury Swipes"
"DOTA_Tooltip_ability_custom_fury_swipes_Description"	"우르사가 적에게 깊은 상처를 남겨 같은 적에게 연속 공격을 할 때 더 큰 피해를 줍니다."
"[english]DOTA_Tooltip_ability_custom_fury_swipes_Description"	"Ursa's claws dig deeper wounds in the enemy, causing consecutive attacks to the same enemy to deal more damage."
"DOTA_Tooltip_ability_custom_fury_swipes_damage_per_stack"	"중첩당 피해:"
"[english]DOTA_Tooltip_ability_custom_fury_swipes_damage_per_stack"	"DAMAGE PER STACK:"
"DOTA_Tooltip_ability_snowball_lua"	"눈덩이"
"[english]DOTA_Tooltip_ability_snowball_lua"	"Snowball Lua"
"DOTA_Tooltip_ability_snowball_lua_Description"	""
"[english]DOTA_Tooltip_ability_snowball_lua_Description"	""
"DOTA_Tooltip_ability_impetus_lua"	"추진력"
"[english]DOTA_Tooltip_ability_impetus_lua"	"Impetus Lua"
"DOTA_Tooltip_ability_impetus_lua_Description"	""
"[english]DOTA_Tooltip_ability_impetus_lua_Description"	""
"DOTA_Tooltip_ability_remote_mine_lua_damage_per_tick"	"적용 1회당 피해:"
"[english]DOTA_Tooltip_ability_remote_mine_lua_damage_per_tick"	"DAMAGE PER TICK:"
"DOTA_Tooltip_ability_remote_mine_lua_tick_rate"	"적용 1회당 비율:"
"[english]DOTA_Tooltip_ability_remote_mine_lua_tick_rate"	"TICK RATE:"
"DOTA_Tooltip_ability_place_propulsion_mine_lua"	"추진 지뢰"
"[english]DOTA_Tooltip_ability_place_propulsion_mine_lua"	"Propulsion Mine"
"DOTA_Tooltip_ability_place_propulsion_mine_lua_Description"	"폭발하면 근처의 적을 뒤로 밀쳐내는 추진 지뢰 한 개를 설치합니다."
"[english]DOTA_Tooltip_ability_place_propulsion_mine_lua_Description"	"Place a Propulsion Mine that knocks back nearby units when detonated."
"DOTA_Tooltip_ability_place_propulsion_mine_lua_tooltip_damage"	"피해:"
"[english]DOTA_Tooltip_ability_place_propulsion_mine_lua_tooltip_damage"	"DAMAGE:"
"DOTA_Tooltip_ability_place_propulsion_mine_lua_tooltip_damage_radius"	"피해 반경:"
"[english]DOTA_Tooltip_ability_place_propulsion_mine_lua_tooltip_damage_radius"	"DAMAGE RADIUS:"
"DOTA_Tooltip_ability_place_propulsion_mine_lua_tooltip_knockback_distance"	"밀치기 거리:"
"[english]DOTA_Tooltip_ability_place_propulsion_mine_lua_tooltip_knockback_distance"	"KNOCKBACK DISTANCE:"
"DOTA_Tooltip_ability_detonate_propulsion_mine_lua"	"터뜨리기"
"[english]DOTA_Tooltip_ability_detonate_propulsion_mine_lua"	"Detonate"
"DOTA_Tooltip_ability_detonate_propulsion_mine_lua_Description"	"현재 설치된 추진 지뢰를 모두 터뜨립니다."
"[english]DOTA_Tooltip_ability_detonate_propulsion_mine_lua_Description"	"Detonates all currently placed propulsion mines."
"DOTA_Tooltip_ability_propulsion_mine_lua"	"추진 지뢰"
"[english]DOTA_Tooltip_ability_propulsion_mine_lua"	"Propulsion Mine"
"DOTA_Tooltip_ability_propulsion_mine_lua_Description"	""
"[english]DOTA_Tooltip_ability_propulsion_mine_lua_Description"	""
"DOTA_Tooltip_ability_propulsion_mine_lua_damage"	"피해:"
"[english]DOTA_Tooltip_ability_propulsion_mine_lua_damage"	"DAMAGE:"
"DOTA_Tooltip_ability_propulsion_mine_lua_radius"	"반경:"
"[english]DOTA_Tooltip_ability_propulsion_mine_lua_radius"	"RADIUS:"
"DOTA_Tooltip_ability_propulsion_mine_lua_knockback_distance"	"밀치기 거리:"
"[english]DOTA_Tooltip_ability_propulsion_mine_lua_knockback_distance"	"KNOCKBACK DISTANCE:"
"DOTA_Tooltip_ability_breathe_fire"	"불꽃 숨결"
"[english]DOTA_Tooltip_ability_breathe_fire"	"Breathe Fire"
"DOTA_Tooltip_ability_breathe_fire_Description"	""
"[english]DOTA_Tooltip_ability_breathe_fire_Description"	""
"DOTA_Tooltip_ability_breathe_fire_start_radius"	"시작 반경:"
"[english]DOTA_Tooltip_ability_breathe_fire_start_radius"	"START RADIUS:"
"DOTA_Tooltip_ability_breathe_fire_end_radius"	"종료 반경:"
"[english]DOTA_Tooltip_ability_breathe_fire_end_radius"	"END RADIUS:"
"DOTA_Tooltip_ability_breathe_fire_range"	"범위:"
"[english]DOTA_Tooltip_ability_breathe_fire_range"	"RANGE:"
"DOTA_Tooltip_ability_breathe_fire_speed"	"속도:"
"[english]DOTA_Tooltip_ability_breathe_fire_speed"	"SPEED:"
"DOTA_Tooltip_ability_breathe_fire_fire_damage"	"화염 피해:"
"[english]DOTA_Tooltip_ability_breathe_fire_fire_damage"	"FIRE DAMAGE:"
"DOTA_Tooltip_ability_refraction_lua"	"굴절의 보호막"
"[english]DOTA_Tooltip_ability_refraction_lua"	"Refraction"
"DOTA_Tooltip_ability_refraction_lua_Description"	"활성화 상태에서 모든 피해를 막아내지만, 마나가 소진됩니다."
"[english]DOTA_Tooltip_ability_refraction_lua_Description"	"Blocks all damage while activated, but drains your mana."
"DOTA_Tooltip_ability_refraction_lua_mana_per_second"	"초당 마나:"
"[english]DOTA_Tooltip_ability_refraction_lua_mana_per_second"	"MANA PER SECOND:"
"DOTA_Tooltip_ability_campfire"	"모닥불"
"[english]DOTA_Tooltip_ability_campfire"	"Campfire"
"DOTA_Tooltip_ability_campfire_Description"	""
"[english]DOTA_Tooltip_ability_campfire_Description"	""
"DOTA_Tooltip_ability_campfire_aura_radius"	"오라 반경:"
"[english]DOTA_Tooltip_ability_campfire_aura_radius"	"AURA RADIUS:"
"DOTA_Tooltip_ability_campfire_aura_mana_regen"	"오라 마나 재생:"
"[english]DOTA_Tooltip_ability_campfire_aura_mana_regen"	"AURA MANA REGEN:"
"DOTA_Tooltip_ability_campfire_aura_hp_regen"	"오라 체력 재생:"
"[english]DOTA_Tooltip_ability_campfire_aura_hp_regen"	"AURA HP REGEN:"
"DOTA_Tooltip_ability_campfire_campfire_duration"	"모닥불 지속시간:"
"[english]DOTA_Tooltip_ability_campfire_campfire_duration"	"CAMPFIRE DURATION:"
"DOTA_Tooltip_ability_weather_dummy_passive"	"날씨 모형 지속효과"
"[english]DOTA_Tooltip_ability_weather_dummy_passive"	"Weather Dummy Passive"
"DOTA_Tooltip_ability_weather_dummy_passive_Description"	""
"[english]DOTA_Tooltip_ability_weather_dummy_passive_Description"	""
"DOTA_Tooltip_ability_weather_snowstorm"	"날씨 눈보라"
"[english]DOTA_Tooltip_ability_weather_snowstorm"	"Weather Snowstorm"
"DOTA_Tooltip_ability_weather_snowstorm_Description"	""
"[english]DOTA_Tooltip_ability_weather_snowstorm_Description"	""
"DOTA_Tooltip_ability_custom_cold_feet"	"발 얼리기"
"[english]DOTA_Tooltip_ability_custom_cold_feet"	"Cold Feet"
"DOTA_Tooltip_ability_custom_cold_feet_Description"	"얼음의 마법으로 적의 발을 얼려 지속 피해를 줍니다. 대상이 최초 시전 지점에서 멀리 벗어나면 효과를 해제할 수 있습니다. 대상이 효과 범위 바깥으로 나가지 않으면 그 자리에서 기절하고 얼어붙습니다."
"[english]DOTA_Tooltip_ability_custom_cold_feet_Description"	"Places a frozen hex on an enemy unit that deals damage over time, but can be dispelled by moving away from the initial cast point. If the enemy unit doesn't move out of the given range, it will be stunned and frozen in place."
"DOTA_Tooltip_ability_custom_cold_feet_damage"	"피해:"
"[english]DOTA_Tooltip_ability_custom_cold_feet_damage"	"DAMAGE:"
"DOTA_Tooltip_ability_custom_cold_feet_break_distance"	"단절 거리:"
"[english]DOTA_Tooltip_ability_custom_cold_feet_break_distance"	"BREAK DISTANCE:"
"DOTA_Tooltip_ability_custom_cold_feet_stun_duration"	"기절 지속시간:"
"[english]DOTA_Tooltip_ability_custom_cold_feet_stun_duration"	"STUN DURATION:"
"DOTA_Tooltip_ability_custom_cold_feet_cast_range_tooltip"	"시전 범위:"
"[english]DOTA_Tooltip_ability_custom_cold_feet_cast_range_tooltip"	"CAST RANGE:"
"DOTA_Tooltip_ability_custom_ice_vortex"	"얼음 소용돌이"
"[english]DOTA_Tooltip_ability_custom_ice_vortex"	"Ice Vortex"
"DOTA_Tooltip_ability_custom_ice_vortex_Description"	"냉기 에너지의 소용돌이를 생성하여 효과 범위 내 적들의 마법 저항력과 이동 속도를 감소시킵니다."
"[english]DOTA_Tooltip_ability_custom_ice_vortex_Description"	"Creates a vortex of icy energy that slows movement speed and increases magic damage done in its range."
"DOTA_Tooltip_ability_custom_ice_vortex_radius"	"반경:"
"[english]DOTA_Tooltip_ability_custom_ice_vortex_radius"	"RADIUS:"
"DOTA_Tooltip_ability_custom_ice_vortex_movement_speed_pct"	"이동 속도:"
"[english]DOTA_Tooltip_ability_custom_ice_vortex_movement_speed_pct"	"MOVEMENT SPEED:"
"DOTA_Tooltip_ability_whirling_death_lua"	"죽음의 회전날"
"[english]DOTA_Tooltip_ability_whirling_death_lua"	"Whirling Death"
"DOTA_Tooltip_ability_whirling_death_lua_Description"	"극도로 날카로운 톱날을 회전시켜 주위 적에게 피해를 주고 나무를 쓰러뜨립니다."
"[english]DOTA_Tooltip_ability_whirling_death_lua_Description"	"Timbersaw whirls extremely sharp edges, damaging enemies and destroying trees around him in an area."
"DOTA_Tooltip_ability_whirling_death_lua_whirling_radius"	"반경:"
"[english]DOTA_Tooltip_ability_whirling_death_lua_whirling_radius"	"RADIUS:"
"DOTA_Tooltip_ability_timber_chain_lua"	"벌목꾼 사슬"
"[english]DOTA_Tooltip_ability_timber_chain_lua"	"Timber Chain"
"DOTA_Tooltip_ability_timber_chain_lua_Description"	"사슬을 던져 경로상에서 처음으로 사슬에 맞는 나무를 붙들고 그 나무의 위치로 이동합니다."
"[english]DOTA_Tooltip_ability_timber_chain_lua_Description"	"Timbersaw fires a chain that embeds itself in the first tree it hits, pulling him towards it."
"DOTA_Tooltip_ability_timber_chain_lua_chain_radius"	"나무 수색 반경:"
"[english]DOTA_Tooltip_ability_timber_chain_lua_chain_radius"	"TREE SEARCH RADIUS:"
"DOTA_Tooltip_ability_timber_chain_lua_range"	"범위:"
"[english]DOTA_Tooltip_ability_timber_chain_lua_range"	"RANGE:"
"DOTA_Tooltip_ability_chakram_lua"	"차크람"
"[english]DOTA_Tooltip_ability_chakram_lua"	"Chakram"
"DOTA_Tooltip_ability_chakram_lua_Description"	"대상 지점에 대형 톱날을 날려 보냅니다. 날아간 톱날은 목표 지점에서 회전합니다. 톱날은 발사 및 회수 시 나무를 베어냅니다."
"[english]DOTA_Tooltip_ability_chakram_lua_Description"	"Fires your main saw blade at the target location where it will spin in place. The blade cuts down trees in its path when fired and retracted."
"DOTA_Tooltip_ability_chakram_lua_speed"	"속도:"
"[english]DOTA_Tooltip_ability_chakram_lua_speed"	"SPEED:"
"DOTA_Tooltip_ability_chakram_lua_radius"	"효과 반경:"
"[english]DOTA_Tooltip_ability_chakram_lua_radius"	"EFFECT RADIUS:"
"DOTA_Tooltip_ability_chakram_lua_break_distance"	"단절 거리:"
"[english]DOTA_Tooltip_ability_chakram_lua_break_distance"	"BREAK DISTANCE:"
"DOTA_Tooltip_ability_chakram_return_lua"	"차크람 회수"
"[english]DOTA_Tooltip_ability_chakram_return_lua"	"Chakram Return"
"DOTA_Tooltip_ability_chakram_return_lua_Description"	"차크람을 회수합니다."
"[english]DOTA_Tooltip_ability_chakram_return_lua_Description"	"Returns the Chakram to Timbersaw."
"DOTA_Tooltip_ability_containers_lua_targeting"	"컨테이너 대상 지정"
"[english]DOTA_Tooltip_ability_containers_lua_targeting"	"Containers Targeting"
"DOTA_Tooltip_ability_containers_lua_targeting_Description"	""
"[english]DOTA_Tooltip_ability_containers_lua_targeting_Description"	""
"DOTA_Tooltip_ability_containers_lua_targeting_tree"	"컨테이너 대상 지정 나무"
"[english]DOTA_Tooltip_ability_containers_lua_targeting_tree"	"Containers Targeting Tree"
"DOTA_Tooltip_ability_containers_lua_targeting_tree_Description"	""
"[english]DOTA_Tooltip_ability_containers_lua_targeting_tree_Description"	""
"DOTA_Tooltip_ability_dummy_unit"	"모형 유닛"
"[english]DOTA_Tooltip_ability_dummy_unit"	"Dummy Unit"
"DOTA_Tooltip_ability_dummy_unit_Description"	""
"[english]DOTA_Tooltip_ability_dummy_unit_Description"	""
"DOTA_Tooltip_ability_barebones_empty1"	"Barebones 없음1"
"[english]DOTA_Tooltip_ability_barebones_empty1"	"Barebones Empty1"
"DOTA_Tooltip_ability_barebones_empty1_Description"	""
"[english]DOTA_Tooltip_ability_barebones_empty1_Description"	""
"DOTA_Tooltip_ability_barebones_empty2"	"Barebones 없음2"
"[english]DOTA_Tooltip_ability_barebones_empty2"	"Barebones Empty2"
"DOTA_Tooltip_ability_barebones_empty2_Description"	""
"[english]DOTA_Tooltip_ability_barebones_empty2_Description"	""
"DOTA_Tooltip_ability_barebones_empty3"	"Barebones 없음3"
"[english]DOTA_Tooltip_ability_barebones_empty3"	"Barebones Empty3"
"DOTA_Tooltip_ability_barebones_empty3_Description"	""
"[english]DOTA_Tooltip_ability_barebones_empty3_Description"	""
"DOTA_Tooltip_ability_barebones_empty4"	"Barebones 없음4"
"[english]DOTA_Tooltip_ability_barebones_empty4"	"Barebones Empty4"
"DOTA_Tooltip_ability_barebones_empty4_Description"	""
"[english]DOTA_Tooltip_ability_barebones_empty4_Description"	""
"DOTA_Tooltip_ability_barebones_empty5"	"Barebones 없음5"
"[english]DOTA_Tooltip_ability_barebones_empty5"	"Barebones Empty5"
"DOTA_Tooltip_ability_barebones_empty5_Description"	""
"[english]DOTA_Tooltip_ability_barebones_empty5_Description"	""
"DOTA_Tooltip_ability_barebones_empty6"	"Barebones 없음6"
"[english]DOTA_Tooltip_ability_barebones_empty6"	"Barebones Empty6"
"DOTA_Tooltip_ability_barebones_empty6_Description"	""
"[english]DOTA_Tooltip_ability_barebones_empty6_Description"	""
"DOTA_Tooltip_ability_item_rune_heal"	"재생화"
"[english]DOTA_Tooltip_ability_item_rune_heal"	"Regeneration"
"DOTA_Tooltip_ability_item_rune_heal_Description"	""
"[english]DOTA_Tooltip_ability_item_rune_heal_Description"	""
"DOTA_Tooltip_ability_item_rune_heal_heal"	"치유:"
"[english]DOTA_Tooltip_ability_item_rune_heal_heal"	"HEAL:"
"DOTA_Tooltip_ability_item_rune_full_heal"	"재생화"
"[english]DOTA_Tooltip_ability_item_rune_full_heal"	"Regeneration"
"DOTA_Tooltip_ability_item_rune_full_heal_Description"	""
"[english]DOTA_Tooltip_ability_item_rune_full_heal_Description"	""
"DOTA_Tooltip_ability_item_rune_full_heal_heal"	"치유:"
"[english]DOTA_Tooltip_ability_item_rune_full_heal_heal"	"HEAL:"
"DOTA_Tooltip_ability_item_rune_double_damage_duration"	"지속시간:"
"[english]DOTA_Tooltip_ability_item_rune_double_damage_duration"	"DURATION:"
"DOTA_Tooltip_ability_item_blink_lua"	"점멸 단검"
"[english]DOTA_Tooltip_ability_item_blink_lua"	"Blink Dagger"
"DOTA_Tooltip_ability_item_blink_lua_Description"	""
"[english]DOTA_Tooltip_ability_item_blink_lua_Description"	""
"DOTA_Tooltip_ability_item_blink_lua_blink_range"	"점멸 범위:"
"[english]DOTA_Tooltip_ability_item_blink_lua_blink_range"	"BLINK RANGE:"
"DOTA_Tooltip_ability_item_rune_haste"	"신속화"
"[english]DOTA_Tooltip_ability_item_rune_haste"	"Haste"
"DOTA_Tooltip_ability_item_rune_haste_Description"	""
"[english]DOTA_Tooltip_ability_item_rune_haste_Description"	""
"DOTA_Tooltip_ability_item_rune_haste_duration"	"지속시간:"
"[english]DOTA_Tooltip_ability_item_rune_haste_duration"	"DURATION:"
"DOTA_Tooltip_ability_item_rune_double_damage"	"더블 대미지"
"[english]DOTA_Tooltip_ability_item_rune_double_damage"	"Double Damage"
"DOTA_Tooltip_ability_item_rune_double_damage_Description"	""
"[english]DOTA_Tooltip_ability_item_rune_double_damage_Description"	""
"DOTA_Tooltip_ability_item_containers_lua_pack"	"컨테이너 팩"
"[english]DOTA_Tooltip_ability_item_containers_lua_pack"	"Containers Pack"
"DOTA_Tooltip_ability_item_containers_lua_pack_Description"	""
"[english]DOTA_Tooltip_ability_item_containers_lua_pack_Description"	""
"DOTA_Frostivus_2017_Suicidal_Axe_Name"	"장렬히 전사할 도끼"
"[english]DOTA_Frostivus_2017_Suicidal_Axe_Name"	"Suicidal Axe"
"DOTA_Frostivus_2017_Suicidal_Pudge_Name"	"자살하려는 퍼지"
"[english]DOTA_Frostivus_2017_Suicidal_Pudge_Name"	"Suicidal Pudge"
"DOTA_Frostivus_2017_Chain_Frost_Tag_Name"	"연쇄 빙결 얼음땡"
"[english]DOTA_Frostivus_2017_Chain_Frost_Tag_Name"	"Chain Frost Tag"
"DOTA_Frostivus_2017_Minefield_Survival_Name"	"지뢰밭에서 살아남기"
"[english]DOTA_Frostivus_2017_Minefield_Survival_Name"	"Minefield Survival"
"DOTA_Frostivus_2017_Minefield_Racing_Name"	"지뢰밭 경주"
"[english]DOTA_Frostivus_2017_Minefield_Racing_Name"	"Minefield Racing"
"DOTA_Frostivus_2017_Arrow_Practice_Name"	"활쏘기 연습"
"[english]DOTA_Frostivus_2017_Arrow_Practice_Name"	"Arrow Practice"
"DOTA_Frostivus_2017_Survive_the_Winter_Name"	"한겨울 버텨내기"
"[english]DOTA_Frostivus_2017_Survive_the_Winter_Name"	"Survive the Winter"
"DOTA_Frostivus_2017_Pudge_Wars_Name"	"퍼지 전쟁"
"[english]DOTA_Frostivus_2017_Pudge_Wars_Name"	"Pudge Wars"
"DOTA_Frostivus_2017_Shadowfiend_Wars_Name"	"그림자 마귀 전쟁"
"[english]DOTA_Frostivus_2017_Shadowfiend_Wars_Name"	"Shadowfiend Wars"
"DOTA_Frostivus_2017_Monkey_Mischief_Name"	"원숭이 둔갑술"
"[english]DOTA_Frostivus_2017_Monkey_Mischief_Name"	"Monkey Mischief"
"DOTA_Frostivus_2017_Kaolin_Soccer_Name"	"승부의 바위 차기"
"[english]DOTA_Frostivus_2017_Kaolin_Soccer_Name"	"Kaolin Soccer"
"DOTA_Frostivus_2017_Boar_Bear_Hawk_Name"	"멧돼지, 곰, 매"
"[english]DOTA_Frostivus_2017_Boar_Bear_Hawk_Name"	"Boar, Bear, Hawk"
"DOTA_Frostivus_2017_Archer_Wars_Name"	"궁수 전쟁"
"[english]DOTA_Frostivus_2017_Archer_Wars_Name"	"Archer Wars"
"DOTA_Frostivus_2017_Ogre_Seal_Survival_Name"	"오거 바다표범으로부터 살아남기"
"[english]DOTA_Frostivus_2017_Ogre_Seal_Survival_Name"	"Ogre Seal Survival"
"DOTA_Frostivus_2017_Ogre_Survival_Name"	"오거로부터 살아남기"
"[english]DOTA_Frostivus_2017_Ogre_Survival_Name"	"Ogre Survival"
"DOTA_Frostivus_2017_Red_Light_Green_Light_Name"	"빨간 불 안돼요, 초록 불 달려요"
"[english]DOTA_Frostivus_2017_Red_Light_Green_Light_Name"	"Red Light, Green Light"
"DOTA_Frostivus_2017_Spirit_Breaker_Race_Name"	"영혼 파괴자 경주"
"[english]DOTA_Frostivus_2017_Spirit_Breaker_Race_Name"	"Spirit Breaker Race"
"DOTA_Frostivus_2017_Zombies_Zombies_Zombies_Name"	"좀비 좀비 좀비"
"[english]DOTA_Frostivus_2017_Zombies_Zombies_Zombies_Name"	"Zombies Zombies Zombies"
"DOTA_Frostivus_2017_Poke_the_Ogre_Name"	"열 번 찔러 안 넘어가는 오거"
"[english]DOTA_Frostivus_2017_Poke_the_Ogre_Name"	"Poke the Ogre"
"DOTA_Frostivus_2017_Follow_the_Leader_Name"	"지도자처럼 해봐요, 이렇게"
"[english]DOTA_Frostivus_2017_Follow_the_Leader_Name"	"Follow the Leader"
"DOTA_Frostivus_2017_Coin_Collection_Name"	"동전 모으기"
"[english]DOTA_Frostivus_2017_Coin_Collection_Name"	"Coin Collection"
"DOTA_Frostivus_2017_Spirit_Breaker_Sumo_Name"	"영혼 파괴자 씨름"
"[english]DOTA_Frostivus_2017_Spirit_Breaker_Sumo_Name"	"Spirit Breaker Sumo"
"DOTA_Frostivus_2017_Refraction_Survival_Name"	"굴절의 보호막으로 살아남기"
"[english]DOTA_Frostivus_2017_Refraction_Survival_Name"	"Refraction Survival"
"DOTA_Frostivus_2017_Campfire_Survival_Name"	"모닥불 살아남기"
"[english]DOTA_Frostivus_2017_Campfire_Survival_Name"	"Campfire Survival"
"DOTA_Frostivus_2017_Impetus_Throwing_Contest_Name"	"추진력 받아 던지기 대회"
"[english]DOTA_Frostivus_2017_Impetus_Throwing_Contest_Name"	"Impetus Throwing Contest"
"DOTA_Frostivus_2017_Techies_Knockout_Name"	"기술단 밀어붙이기"
"[english]DOTA_Frostivus_2017_Techies_Knockout_Name"	"Techies Knockout"
"DOTA_Frostivus_2017_Fire_Trap_Race_Name"	"화염 함정 경주"
"[english]DOTA_Frostivus_2017_Fire_Trap_Race_Name"	"Fire Trap Race"
"DOTA_Frostivus_2017_Avalanche_Survival_Name"	"산사태에서 살아남기"
"[english]DOTA_Frostivus_2017_Avalanche_Survival_Name"	"Avalanche Survival"
"DOTA_Frostivus_2017_An_End_To_All_Magic_Name"	"모든 마법에 종말을"
"[english]DOTA_Frostivus_2017_An_End_To_All_Magic_Name"	"An End To All Magic"
"DOTA_Frostivus_2017_Deforestation_Name"	"삼림 파괴"
"[english]DOTA_Frostivus_2017_Deforestation_Name"	"Deforestation"
"DOTA_Frostivus2017_Suicidal_Axe_Desc"	"플레이어 중에 가장 먼저 죽기"
"[english]DOTA_Frostivus2017_Suicidal_Axe_Desc"	"Be the first player to die"
"DOTA_Frostivus2017_Suicidal_Pudge_Desc"	"자살하려는 퍼지에게서 벗어나기"
"[english]DOTA_Frostivus2017_Suicidal_Pudge_Desc"	"Stay away from the suicidal pudge"
"DOTA_Frostivus2017_Chain_Frost_Tag_Desc"	"리치의 연쇄 빙결 피하기"
"[english]DOTA_Frostivus2017_Chain_Frost_Tag_Desc"	"Avoid the Lich's Chain Frosts"
"DOTA_Frostivus2017_Minefield_Survival_Desc"	"폭발하는 폭탄 피하기"
"[english]DOTA_Frostivus2017_Minefield_Survival_Desc"	"Avoid the exploding bombs"
"DOTA_Frostivus2017_Minefield_Racing_Desc"	"번개로 길을 밝히며 위험한 지뢰밭을 뚫고 나가기"
"[english]DOTA_Frostivus2017_Minefield_Racing_Desc"	"Navigate a dangerous minefield, using lightning to guide your way"
"DOTA_Frostivus2017_Arrow_Practice_Desc"	"화살 하나로 종 한 개 쏘아 맞히기"
"[english]DOTA_Frostivus2017_Arrow_Practice_Desc"	"Shoot one of the bells with an Arrow"
"DOTA_Frostivus2017_Survive_the_Winter_Desc"	"재생화 룬을 획득하여 혹한의 겨울에서 살아남기"
"[english]DOTA_Frostivus2017_Survive_the_Winter_Desc"	"Pick up Regen Runes to survive the freezing winter"
"DOTA_Frostivus2017_Pudge_Wars_Desc"	"다른 플레이어를 처치하고 점수 획득"
"[english]DOTA_Frostivus2017_Pudge_Wars_Desc"	"Get points by killing other players"
"DOTA_Frostivus2017_Kaolin_Soccer_Desc"	"자신의 골대에 공이 오지 못하게 하기"
"[english]DOTA_Frostivus2017_Kaolin_Soccer_Desc"	"Keep the ball out of your goal"
"DOTA_Frostivus2017_Archer_Wars_Desc"	"최후의 궁수"
"[english]DOTA_Frostivus2017_Archer_Wars_Desc"	"Last Archer Standing"
"DOTA_Frostivus2017_Ogre_Seal_Survival_Desc"	"오거 바다표범에게 맞지 않기"
"[english]DOTA_Frostivus2017_Ogre_Seal_Survival_Desc"	"Avoid getting crushed by the Ogre Seal"
"DOTA_Frostivus2017_Ogre_Survival_Desc"	"오거에게 맞지 않기"
"[english]DOTA_Frostivus2017_Ogre_Survival_Desc"	"Avoid getting crushed by the Ogre"
"DOTA_Frostivus2017_Red_Light_Green_Light_Desc"	"파열로 죽지 않고 끝까지 완주하기"
"[english]DOTA_Frostivus2017_Red_Light_Green_Light_Desc"	"Make it to the end of the race without being killed by rupture"
"DOTA_Frostivus2017_Spirit_Breaker_Race_Desc"	"돌진을 연타하여 앞으로 이동"
"[english]DOTA_Frostivus2017_Spirit_Breaker_Race_Desc"	"Spam Charge to move forwards"
"DOTA_Frostivus2017_Zombies_Zombies_Zombies_Desc"	"좀비 최후의 날에서 살아남기"
"[english]DOTA_Frostivus2017_Zombies_Zombies_Zombies_Desc"	"Survive the Zombie Apocalypse"
"DOTA_Frostivus2017_Poke_the_Ogre_Desc"	"제한 시간 안에 오거에게 가장 큰 피해를 주어야 합니다. 분노의 발톱은 다른 플레이어와 중첩됩니다."
"[english]DOTA_Frostivus2017_Poke_the_Ogre_Desc"	"Do the most damage to the Ogre before time runs out. Fury Swipes stacks with other players."
"DOTA_Frostivus2017_Follow_the_Leader_Desc"	"원소술사와 같은 주문을 조합\n\n주문을 잘못 조합하거나 시간 안에 조합하지 못하면 피해받음"
"[english]DOTA_Frostivus2017_Follow_the_Leader_Desc"	"Invoke the same spells as Invoker\n\nTake damage for invoking the wrong spell, or not invoking on time"
"DOTA_Frostivus2017_Coin_Collection_Desc"	"제한 시간 안에 동전을 최대한 많이 모으기"
"[english]DOTA_Frostivus2017_Coin_Collection_Desc"	"Collect the most coins before time runs out"
"DOTA_Frostivus2017_Spirit_Breaker_Sumo_Desc"	"다른 플레이어를 경계 밖으로 밀어내기"
"[english]DOTA_Frostivus2017_Spirit_Breaker_Sumo_Desc"	"Try to push other players out of bounds"
"DOTA_Frostivus2017_Refraction_Survival_Desc"	"굴절의 보호막으로 불길에서 살아남아야 합니다. 굴절의 보호막을 계속 켜두면 마나가 소진됩니다."
"[english]DOTA_Frostivus2017_Refraction_Survival_Desc"	"Use Refraction to survive the fire. Keeping Refraction on drains mana."
"DOTA_Frostivus2017_Impetus_Throwing_Contest_Desc"	"추진력을 가장 먼 거리까지 시전해야 합니다. 거리는 창이 대상에 닿는 순간에 서 있는 자리를 기준으로 측정됩니다."
"[english]DOTA_Frostivus2017_Impetus_Throwing_Contest_Desc"	"Throw the longest Impetus. Distance is measured from where you are when your lance hits."
"DOTA_Frostivus2017_Techies_Knockout_Desc"	"지뢰를 사용하여 다른 플레이어를 경계 밖으로 밀어내기"
"[english]DOTA_Frostivus2017_Techies_Knockout_Desc"	"Use your mines to push other players out of bounds"
"DOTA_Frostivus2017_Fire_Trap_Race_Desc"	"불에 죽지 않고 끝까지 완주하기"
"[english]DOTA_Frostivus2017_Fire_Trap_Race_Desc"	"Make it to the end without being killed by the fire"
"DOTA_Frostivus2017_An_End_To_All_Magic_Desc"	"원소술사의 굉음 폭발을 피해 단 밖으로 밀려나지 않기"
"[english]DOTA_Frostivus2017_An_End_To_All_Magic_Desc"	"Don't get pushed off the platform by Invoker's Deafening Blasts"
"DOTA_Frostivus2017_Deforestation_Desc"	"제한 시간 안에 나무를 최대한 많이 파괴하세요!"
"[english]DOTA_Frostivus2017_Deforestation_Desc"	"Destroy the most trees before time runs out!"
}
}
