"lang"
{
"Language"	"romanian"
"Tokens"
{
"DOTA_Tooltip_ability_item_bag_of_gold"	"Monedă"
"[english]DOTA_Tooltip_ability_item_bag_of_gold"	"Coin"
"DOTA_GameMode_15"	"Dark Moon"
"[english]DOTA_GameMode_15"	"Dark Moon"
"DOTA_GameMode_19"	"Dark Moon"
"[english]DOTA_GameMode_19"	"Dark Moon"
"DOTA_HUD_Round"	"RUNDĂ"
"[english]DOTA_HUD_Round"	"ROUND"
"DOTA_HUD_EnemiesRemaining"	"INAMICI RĂMAȘI:"
"[english]DOTA_HUD_EnemiesRemaining"	"ENEMIES REMAINING:"
"DOTA_HUD_NextRound"	"RUNDA URMĂTOARE: "
"[english]DOTA_HUD_NextRound"	"NEXT ROUND: "
"DOTA_HUD_RoundStart"	"ÎNCEPEREA RUNDEI!"
"[english]DOTA_HUD_RoundStart"	"ROUND START!"
"DOTA_HUD_Victory"	"VICTORIE!"
"[english]DOTA_HUD_Victory"	"VICTORY!"
"DOTA_HUD_Defeat"	"ÎNFRÂNGERE!"
"[english]DOTA_HUD_Defeat"	"DEFEAT!"
"DOTA_HUD_Kills"	"UCIDERI"
"[english]DOTA_HUD_Kills"	"KILLS"
"DOTA_HUD_Deaths"	"DECESE"
"[english]DOTA_HUD_Deaths"	"DEATHS"
"DOTA_HUD_Saves"	"REÎNVIERI"
"[english]DOTA_HUD_Saves"	"REVIVES"
"DOTA_HUD_Bags"	"PUNGI"
"[english]DOTA_HUD_Bags"	"BAGS"
"DOTA_HUD_PlayAgain"	"Joci din nou?"
"[english]DOTA_HUD_PlayAgain"	"Play Again?"
"DOTA_HUD_Yes"	"DA"
"[english]DOTA_HUD_Yes"	"YES"
"DOTA_HUD_No"	"NU"
"[english]DOTA_HUD_No"	"NO"
"DOTA_HUD_Score"	"SCORUL RUNDEI"
"[english]DOTA_HUD_Score"	"ROUND SCORE"
"DOTA_HUD_TowersRemaining"	"TURNURI RĂMASE"
"[english]DOTA_HUD_TowersRemaining"	"TOWERS REMAINING"
"DOTA_HUD_GoldBags"	"PUNGI CU AUR ADUNATE"
"[english]DOTA_HUD_GoldBags"	"GOLD BAGS COLLECTED"
"DOTA_HUD_GoldBagsMissed"	"PUNGI CU AUR PIERDUTE"
"[english]DOTA_HUD_GoldBagsMissed"	"GOLD BAGS MISSED"
"DOTA_HUD_TeamDeaths"	"DECESE ALE ECHIPEI"
"[english]DOTA_HUD_TeamDeaths"	"TEAM DEATHS"
"DOTA_HUD_DarkMoonPoints"	"PUNCTE"
"[english]DOTA_HUD_DarkMoonPoints"	"POINTS"
"DOTA_HUD_ThisRound"	"PUNCTE ÎN ACEASTĂ RUNDĂ"
"[english]DOTA_HUD_ThisRound"	"POINTS THIS ROUND"
"DOTA_HUD_TotalPoints"	"TOTALUL PUNCTELOR DIN ACEST MECI"
"[english]DOTA_HUD_TotalPoints"	"TOTAL POINTS EARNED THIS MATCH"
"DOTA_HUD_RankThisRound"	"RANGUL ACESTEI RUNDE"
"[english]DOTA_HUD_RankThisRound"	"RANK THIS ROUND"
"DOTA_HUD_RankInfoIcon"	"Rangul este determinat de performanța turnurilor rămase, de numărul pungilor cu aur adunate și de numărul total de decese ale echipei. Punctele obținute nu sunt afectate de rang."
"[english]DOTA_HUD_RankInfoIcon"	"Rank is determined based off performance on Towers Remaining, Gold Bags Collected, and Total Team Deaths.  Points earned are not affected by Rank."
"DOTA_HUD_Mute"	"AMUȚEȘTE"
"[english]DOTA_HUD_Mute"	"MUTE"
"taunt_game_creep"	"Creep"
"[english]taunt_game_creep"	"Creep"
"suicidal_pudge"	"Suicidal Pudge"
"[english]suicidal_pudge"	"Suicidal Pudge"
"custom_necrophos"	"Necrolyte"
"[english]custom_necrophos"	"Necrolyte"
"bloodseeker_game_bloodseeker"	"Bloodseeker"
"[english]bloodseeker_game_bloodseeker"	"Bloodseeker"
"chain_frost_game_lich"	"Lich"
"[english]chain_frost_game_lich"	"Lich"
"chain_frost_game_penguin"	"Penguin"
"[english]chain_frost_game_penguin"	"Penguin"
"techies_game_remote_mine"	"Remote Mine"
"[english]techies_game_remote_mine"	"Remote Mine"
"zuus_race_land_mine"	"Land Mine"
"[english]zuus_race_land_mine"	"Land Mine"
"zuus_race_stasis_trap"	"Stasis Trap"
"[english]zuus_race_stasis_trap"	"Stasis Trap"
"monkey_king_real"	"Monkey King"
"[english]monkey_king_real"	"Monkey King"
"vision_dummy"	"Vision Dummy"
"[english]vision_dummy"	"Vision Dummy"
"npc_dota_creature_ogre_tank"	"Ogre Tank"
"[english]npc_dota_creature_ogre_tank"	"Ogre Tank"
"npc_dota_creature_ogre_tank_boss"	"Ogre Tank Boss"
"[english]npc_dota_creature_ogre_tank_boss"	"Ogre Tank Boss"
"earth_spirit_soccer_ball"	"Minge"
"[english]earth_spirit_soccer_ball"	"Soccer Ball"
"earth_spirit_soccer_goal"	"Gol"
"[english]earth_spirit_soccer_goal"	"Soccer Goal"
"npc_dota_creature_ogre_seal"	"Ogre Seal"
"[english]npc_dota_creature_ogre_seal"	"Ogre Seal"
"npc_dummy_unit"	"Unitate pentru antrenament"
"[english]npc_dummy_unit"	"Dummy Unit"
"npc_dota_fire_trap_ward"	"Fire Trap"
"[english]npc_dota_fire_trap_ward"	"Fire Trap"
"custom_undying_tombstone"	"Tombstone"
"[english]custom_undying_tombstone"	"Tombstone"
"custom_creature_zombie"	"Zombi"
"[english]custom_creature_zombie"	"Zombie"
"propulsion_mine"	"Propulsion Mine"
"[english]propulsion_mine"	"Propulsion Mine"
"npc_dota_weather_dummy"	"Dota Weather Dummy"
"[english]npc_dota_weather_dummy"	"Dota Weather Dummy"
"custom_invoker"	"Invoker"
"[english]custom_invoker"	"Invoker"
"invoker_leader_forge_spirit"	"Forge Spirit"
"[english]invoker_leader_forge_spirit"	"Forge Spirit"
"DOTA_Tooltip_modifier_aoe_rupture_lua"	"Rupture"
"[english]DOTA_Tooltip_modifier_aoe_rupture_lua"	"Rupture"
"DOTA_Tooltip_modifier_heartstopper_aura_visible"	"Heartstopper Aura"
"[english]DOTA_Tooltip_modifier_heartstopper_aura_visible"	"Heartstopper Aura"
"DOTA_Tooltip_modifier_weather_snowstorm_effect"	"Freezing"
"[english]DOTA_Tooltip_modifier_weather_snowstorm_effect"	"Freezing"
"DOTA_Tooltip_modifier_campfire_effect_Description"	"Îndepărtează efectele frigului."
"[english]DOTA_Tooltip_modifier_campfire_effect_Description"	"Removes the effects of cold."
"DOTA_Tooltip_modifier_invoked_spell_to_cast"	"Magie de invocat"
"[english]DOTA_Tooltip_modifier_invoked_spell_to_cast"	"Spell To Cast"
"DOTA_Tooltip_modifier_invoked_spell_to_cast_Description"	"Invocă această magie sau primești damage."
"[english]DOTA_Tooltip_modifier_invoked_spell_to_cast_Description"	"Invoke this spell or take damage."
"DOTA_Tooltip_modifier_rupture_damage"	"Rupture"
"[english]DOTA_Tooltip_modifier_rupture_damage"	"Rupture"
"DOTA_Tooltip_modifier_berserkers_call_lua"	"Berserkers Call"
"[english]DOTA_Tooltip_modifier_berserkers_call_lua"	"Berserkers Call"
"DOTA_Tooltip_modifier_chain_frost_lua"	"Chain Frost"
"[english]DOTA_Tooltip_modifier_chain_frost_lua"	"Chain Frost"
"DOTA_Tooltip_modifier_conjure_image_lua"	"Conjure Image"
"[english]DOTA_Tooltip_modifier_conjure_image_lua"	"Conjure Image"
"DOTA_Tooltip_modifier_illusion_out_of_world"	"Illusion Out Of World"
"[english]DOTA_Tooltip_modifier_illusion_out_of_world"	"Illusion Out Of World"
"DOTA_Tooltip_modifier_shoot_arrow_lua"	"Arrow Stun"
"[english]DOTA_Tooltip_modifier_shoot_arrow_lua"	"Arrow Stun"
"DOTA_Tooltip_modifier_teleport_channel_lua"	"Teleport"
"[english]DOTA_Tooltip_modifier_teleport_channel_lua"	"Teleport"
"DOTA_Tooltip_modifier_greater_bash_lua"	"Greater Bash"
"[english]DOTA_Tooltip_modifier_greater_bash_lua"	"Greater Bash"
"DOTA_Tooltip_modifier_heartstopper_aura_lua"	"Heartstopper Aura"
"[english]DOTA_Tooltip_modifier_heartstopper_aura_lua"	"Heartstopper Aura"
"DOTA_Tooltip_modifier_quas_lua"	"Quas"
"[english]DOTA_Tooltip_modifier_quas_lua"	"Quas"
"DOTA_Tooltip_modifier_wex_lua"	"Wex"
"[english]DOTA_Tooltip_modifier_wex_lua"	"Wex"
"DOTA_Tooltip_modifier_exort_lua"	"Exort"
"[english]DOTA_Tooltip_modifier_exort_lua"	"Exort"
"DOTA_Tooltip_modifier_leader_cold_snap_lua"	"Cold Snap"
"[english]DOTA_Tooltip_modifier_leader_cold_snap_lua"	"Cold Snap"
"DOTA_Tooltip_modifier_rabid_lua"	"Rabid"
"[english]DOTA_Tooltip_modifier_rabid_lua"	"Rabid"
"DOTA_Tooltip_modifier_arrow_lua"	"Arrow"
"[english]DOTA_Tooltip_modifier_arrow_lua"	"Arrow"
"DOTA_Tooltip_modifier_health_lua"	"Health"
"[english]DOTA_Tooltip_modifier_health_lua"	"Health"
"DOTA_Tooltip_modifier_hidden_lua"	"Hidden"
"[english]DOTA_Tooltip_modifier_hidden_lua"	"Hidden"
"DOTA_Tooltip_modifier_invisible_lua"	"Invisible"
"[english]DOTA_Tooltip_modifier_invisible_lua"	"Invisible"
"DOTA_Tooltip_modifier_mana_lua"	"Mana"
"[english]DOTA_Tooltip_modifier_mana_lua"	"Mana"
"DOTA_Tooltip_modifier_ogre_tank_melee_smash_thinker"	"Ogre Melee Smash Thinker"
"[english]DOTA_Tooltip_modifier_ogre_tank_melee_smash_thinker"	"Ogre Melee Smash Thinker"
"DOTA_Tooltip_modifier_ogreseal_flop"	"Ogreseal Flop"
"[english]DOTA_Tooltip_modifier_ogreseal_flop"	"Ogreseal Flop"
"DOTA_Tooltip_modifier_provide_vision_lua"	"Viziune oferită"
"[english]DOTA_Tooltip_modifier_provide_vision_lua"	"Provide Vision"
"DOTA_Tooltip_modifier_rot_lua"	"Rot"
"[english]DOTA_Tooltip_modifier_rot_lua"	"Rot"
"DOTA_Tooltip_modifier_stunned_lua"	"Stunned"
"[english]DOTA_Tooltip_modifier_stunned_lua"	"Stunned"
"DOTA_Tooltip_modifier_vision_dummy"	"Dummy"
"[english]DOTA_Tooltip_modifier_vision_dummy"	"Dummy"
"DOTA_Tooltip_modifier_ogreseal_flying"	"Ogreseal Passive"
"[english]DOTA_Tooltip_modifier_ogreseal_flying"	"Ogreseal Passive"
"DOTA_Tooltip_modifier_propulsion_mine"	"Propulsion Mine"
"[english]DOTA_Tooltip_modifier_propulsion_mine"	"Propulsion Mine"
"DOTA_Tooltip_modifier_proximity_mine"	"Proximity Mine"
"[english]DOTA_Tooltip_modifier_proximity_mine"	"Proximity Mine"
"DOTA_Tooltip_modifier_refraction_lua"	"Refraction"
"[english]DOTA_Tooltip_modifier_refraction_lua"	"Refraction"
"DOTA_Tooltip_modifier_remote_mine"	"Remote Mine"
"[english]DOTA_Tooltip_modifier_remote_mine"	"Remote Mine"
"DOTA_Tooltip_modifier_shapeshift_bear"	"Shapeshift Bear"
"[english]DOTA_Tooltip_modifier_shapeshift_bear"	"Shapeshift Bear"
"DOTA_Tooltip_modifier_shapeshift_boar"	"Shapeshift Boar"
"[english]DOTA_Tooltip_modifier_shapeshift_boar"	"Shapeshift Boar"
"DOTA_Tooltip_modifier_shapeshift_hawk"	"Shapeshift Hawk"
"[english]DOTA_Tooltip_modifier_shapeshift_hawk"	"Shapeshift Hawk"
"DOTA_Tooltip_modifier_shapeshift"	"Shapeshift"
"[english]DOTA_Tooltip_modifier_shapeshift"	"Shapeshift"
"DOTA_Tooltip_modifier_shukuchi_lua"	"Shukuchi"
"[english]DOTA_Tooltip_modifier_shukuchi_lua"	"Shukuchi"
"DOTA_Tooltip_modifier_snowball"	"Snowball"
"[english]DOTA_Tooltip_modifier_snowball"	"Snowball"
"DOTA_Tooltip_modifier_stasis_trap"	"Stasis Trap"
"[english]DOTA_Tooltip_modifier_stasis_trap"	"Stasis Trap"
"DOTA_Tooltip_modifier_stasis_trap_stun"	"Stunned"
"[english]DOTA_Tooltip_modifier_stasis_trap_stun"	"Stunned"
"DOTA_Tooltip_modifier_storegga_avalanche_thinker"	"Avalanche Thinker"
"[english]DOTA_Tooltip_modifier_storegga_avalanche_thinker"	"Avalanche Thinker"
"DOTA_Tooltip_modifier_spawn_zombies"	"Spawn Zombies"
"[english]DOTA_Tooltip_modifier_spawn_zombies"	"Spawn Zombies"
"DOTA_Tooltip_modifier_weather_dummy_passive"	"Dummy"
"[english]DOTA_Tooltip_modifier_weather_dummy_passive"	"Dummy"
"DOTA_Tooltip_modifier_weather_snowstorm"	"Snowstorm"
"[english]DOTA_Tooltip_modifier_weather_snowstorm"	"Snowstorm"
"DOTA_Tooltip_modifier_item_blink_lua"	"Blink"
"[english]DOTA_Tooltip_modifier_item_blink_lua"	"Blink"
"DOTA_Tooltip_modifier_rune_haste"	"Haste"
"[english]DOTA_Tooltip_modifier_rune_haste"	"Haste"
"DOTA_Tooltip_modifier_rune_double_damage"	"Double Damage"
"[english]DOTA_Tooltip_modifier_rune_double_damage"	"Double Damage"
"DOTA_Tooltip_ability_ability_hide_healthbar"	"Ascunde bara de viață"
"[english]DOTA_Tooltip_ability_ability_hide_healthbar"	"Hide Healthbar"
"DOTA_Tooltip_ability_vision_dummy_ability"	"Vision Dummy Ability"
"[english]DOTA_Tooltip_ability_vision_dummy_ability"	"Vision Dummy Ability"
"DOTA_Tooltip_ability_custom_berserkers_call"	"Berserker's Call"
"[english]DOTA_Tooltip_ability_custom_berserkers_call"	"Berserker's Call"
"DOTA_Tooltip_ability_custom_berserkers_call_radius"	"RAZĂ:"
"[english]DOTA_Tooltip_ability_custom_berserkers_call_radius"	"RADIUS:"
"DOTA_Tooltip_ability_custom_berserkers_call_bonus_armor"	"ARMURĂ BONUS:"
"[english]DOTA_Tooltip_ability_custom_berserkers_call_bonus_armor"	"BONUS ARMOR:"
"DOTA_Tooltip_ability_custom_berserkers_call_duration"	"DURATĂ:"
"[english]DOTA_Tooltip_ability_custom_berserkers_call_duration"	"DURATION:"
"DOTA_Tooltip_ability_custom_shadowraze1"	"Custom Shadowraze1"
"[english]DOTA_Tooltip_ability_custom_shadowraze1"	"Custom Shadowraze1"
"DOTA_Tooltip_ability_custom_shadowraze1_Description"	"Shadow Fiend nimicește zona din fața sa, cauzând damage unităților inamice dintr-o zonă."
"[english]DOTA_Tooltip_ability_custom_shadowraze1_Description"	"Shadow Fiend razes the area in front of him, dealing damage to enemy units in an area."
"DOTA_Tooltip_ability_custom_shadowraze1_shadowraze_radius"	"RAZĂ SHADOWRAZE:"
"[english]DOTA_Tooltip_ability_custom_shadowraze1_shadowraze_radius"	"SHADOWRAZE RADIUS:"
"DOTA_Tooltip_ability_custom_shadowraze1_shadowraze_range"	"DISTANȚĂ SHADOWRAZE:"
"[english]DOTA_Tooltip_ability_custom_shadowraze1_shadowraze_range"	"SHADOWRAZE RANGE:"
"DOTA_Tooltip_ability_custom_shadowraze2"	"Custom Shadowraze2"
"[english]DOTA_Tooltip_ability_custom_shadowraze2"	"Custom Shadowraze2"
"DOTA_Tooltip_ability_custom_shadowraze2_Description"	"Shadow Fiend nimicește zona din fața sa, cauzând damage unităților inamice dintr-o zonă."
"[english]DOTA_Tooltip_ability_custom_shadowraze2_Description"	"Shadow Fiend razes the area in front of him, dealing damage to enemy units in an area."
"DOTA_Tooltip_ability_custom_shadowraze2_shadowraze_radius"	"RAZĂ SHADOWRAZE:"
"[english]DOTA_Tooltip_ability_custom_shadowraze2_shadowraze_radius"	"SHADOWRAZE RADIUS:"
"DOTA_Tooltip_ability_custom_shadowraze2_shadowraze_range"	"DISTANȚĂ SHADOWRAZE:"
"[english]DOTA_Tooltip_ability_custom_shadowraze2_shadowraze_range"	"SHADOWRAZE RANGE:"
"DOTA_Tooltip_ability_custom_shadowraze3"	"Custom Shadowraze3"
"[english]DOTA_Tooltip_ability_custom_shadowraze3"	"Custom Shadowraze3"
"DOTA_Tooltip_ability_custom_shadowraze3_Description"	"Shadow Fiend nimicește zona din fața sa, cauzând damage unităților inamice dintr-o zonă."
"[english]DOTA_Tooltip_ability_custom_shadowraze3_Description"	"Shadow Fiend razes the area in front of him, dealing damage to enemy units in an area."
"DOTA_Tooltip_ability_custom_shadowraze3_shadowraze_radius"	"RAZĂ SHADOWRAZE:"
"[english]DOTA_Tooltip_ability_custom_shadowraze3_shadowraze_radius"	"SHADOWRAZE RADIUS:"
"DOTA_Tooltip_ability_custom_shadowraze3_shadowraze_range"	"DISTANȚĂ SHADOWRAZE:"
"[english]DOTA_Tooltip_ability_custom_shadowraze3_shadowraze_range"	"SHADOWRAZE RANGE:"
"DOTA_Tooltip_ability_pudge_rot_lua"	"Rot"
"[english]DOTA_Tooltip_ability_pudge_rot_lua"	"Rot"
"DOTA_Tooltip_ability_pudge_rot_lua_Description"	"Un nor toxic ce cauzează damage intens și încetinește mișcarea - rănind nu numai unitățile inamice, ci și pe Pudge."
"[english]DOTA_Tooltip_ability_pudge_rot_lua_Description"	"A toxic cloud that deals intense damage and slows movement--harming not only enemy units but Pudge himself."
"DOTA_Tooltip_ability_pudge_rot_lua_rot_radius"	"RAZĂ ROT:"
"[english]DOTA_Tooltip_ability_pudge_rot_lua_rot_radius"	"ROT RADIUS:"
"DOTA_Tooltip_ability_pudge_rot_lua_rot_tick"	"INTERVAL ROT:"
"[english]DOTA_Tooltip_ability_pudge_rot_lua_rot_tick"	"ROT TICK:"
"DOTA_Tooltip_ability_pudge_rot_lua_rot_slow"	"ÎNCETINERE ROT:"
"[english]DOTA_Tooltip_ability_pudge_rot_lua_rot_slow"	"ROT SLOW:"
"DOTA_Tooltip_ability_pudge_rot_lua_rot_damage"	"DAMAGE ROT:"
"[english]DOTA_Tooltip_ability_pudge_rot_lua_rot_damage"	"ROT DAMAGE:"
"DOTA_Tooltip_ability_custom_frostbite"	"Frostbite"
"[english]DOTA_Tooltip_ability_custom_frostbite"	"Frostbite"
"DOTA_Tooltip_ability_custom_frostbite_duration"	"DURATA EROULUI:"
"[english]DOTA_Tooltip_ability_custom_frostbite_duration"	"HERO DURATION:"
"DOTA_Tooltip_ability_custom_frostbite_creep_duration"	"DURATA CREEPILOR:"
"[english]DOTA_Tooltip_ability_custom_frostbite_creep_duration"	"CREEP DURATION:"
"DOTA_Tooltip_ability_custom_pudge_meat_hook"	"Meat Hook"
"[english]DOTA_Tooltip_ability_custom_pudge_meat_hook"	"Meat Hook"
"DOTA_Tooltip_ability_custom_pudge_meat_hook_hook_distance"	"DISTANȚA HOOKULUI:"
"[english]DOTA_Tooltip_ability_custom_pudge_meat_hook_hook_distance"	"HOOK DISTANCE:"
"DOTA_Tooltip_ability_chain_frost_lua"	"Chain Frost"
"[english]DOTA_Tooltip_ability_chain_frost_lua"	"Chain Frost"
"DOTA_Tooltip_ability_chain_frost_lua_slow_duration"	"DURATA ÎNCETINIRII:"
"[english]DOTA_Tooltip_ability_chain_frost_lua_slow_duration"	"SLOW DURATION:"
"DOTA_Tooltip_ability_chain_frost_lua_slow_movement_speed"	"ÎNCETINIREA VITEZEI DE MIȘCARE:"
"[english]DOTA_Tooltip_ability_chain_frost_lua_slow_movement_speed"	"SLOW MOVEMENT SPEED:"
"DOTA_Tooltip_ability_chain_frost_lua_jump_range"	"DISTANȚA SĂRITURII:"
"[english]DOTA_Tooltip_ability_chain_frost_lua_jump_range"	"JUMP RANGE:"
"DOTA_Tooltip_ability_chain_frost_lua_projectile_speed"	"VITEZA PROIECTILULUI:"
"[english]DOTA_Tooltip_ability_chain_frost_lua_projectile_speed"	"PROJECTILE SPEED:"
"DOTA_Tooltip_ability_chain_frost_lua_damage"	"DAMAGE:"
"[english]DOTA_Tooltip_ability_chain_frost_lua_damage"	"DAMAGE:"
"DOTA_Tooltip_ability_aoe_rupture_lua"	"Aoe Rupture"
"[english]DOTA_Tooltip_ability_aoe_rupture_lua"	"Aoe Rupture"
"DOTA_Tooltip_ability_ogreseal_flop"	"Ogreseal Flop"
"[english]DOTA_Tooltip_ability_ogreseal_flop"	"Ogreseal Flop"
"DOTA_Tooltip_ability_ogreseal_flop_Description"	"Flip Flop Flip Flop"
"[english]DOTA_Tooltip_ability_ogreseal_flop_Description"	"Flip Flop Flip Flop"
"DOTA_Tooltip_ability_ogreseal_flop_radius"	"RAZĂ:"
"[english]DOTA_Tooltip_ability_ogreseal_flop_radius"	"RADIUS:"
"DOTA_Tooltip_ability_ogreseal_flop_damage"	"DAMAGE:"
"[english]DOTA_Tooltip_ability_ogreseal_flop_damage"	"DAMAGE:"
"DOTA_Tooltip_ability_ogreseal_flop_stun_duration"	"DURATA NĂUCIRII:"
"[english]DOTA_Tooltip_ability_ogreseal_flop_stun_duration"	"STUN DURATION:"
"DOTA_Tooltip_ability_shukuchi_lua"	"Shukuchi"
"[english]DOTA_Tooltip_ability_shukuchi_lua"	"Shukuchi"
"DOTA_Tooltip_ability_shukuchi_lua_move_speed"	"VITEZĂ DE MIȘCARE:"
"[english]DOTA_Tooltip_ability_shukuchi_lua_move_speed"	"MOVE SPEED:"
"DOTA_Tooltip_ability_shukuchi_lua_duration"	"DURATĂ:"
"[english]DOTA_Tooltip_ability_shukuchi_lua_duration"	"DURATION:"
"DOTA_Tooltip_ability_mirana_arrow_lua_Description"	"Trage la distanță mare o săgeată cu precizie mortală, care năucește și face damage primei unități inamice pe care o lovește. Se reîmprospătează după ce lovește ținta."
"[english]DOTA_Tooltip_ability_mirana_arrow_lua_Description"	"Fires a long-range arrow with deadly precision, which stuns and damages the first enemy unit it strikes. Refreshes upon hitting the target."
"DOTA_Tooltip_ability_mirana_arrow_lua_stun_duration"	"DURATA NĂUCIRII:"
"[english]DOTA_Tooltip_ability_mirana_arrow_lua_stun_duration"	"STUN DURATION:"
"DOTA_Tooltip_ability_shapeshift_boar_lua_transformation_time"	"TIMP DE TRANSFORMARE:"
"[english]DOTA_Tooltip_ability_shapeshift_boar_lua_transformation_time"	"TRANSFORMATION TIME:"
"DOTA_Tooltip_ability_shapeshift_bear_lua_transformation_time"	"TIMP DE TRANSFORMARE:"
"[english]DOTA_Tooltip_ability_shapeshift_bear_lua_transformation_time"	"TRANSFORMATION TIME:"
"DOTA_Tooltip_ability_shapeshift_hawk_lua_transformation_time"	"TIMP DE TRANSFORMARE:"
"[english]DOTA_Tooltip_ability_shapeshift_hawk_lua_transformation_time"	"TRANSFORMATION TIME:"
"DOTA_Tooltip_ability_drow_shoot_arrow_lua_damage"	"DAMAGE:"
"[english]DOTA_Tooltip_ability_drow_shoot_arrow_lua_damage"	"DAMAGE:"
"DOTA_Tooltip_ability_remote_mine_lua"	"Remote Mine"
"[english]DOTA_Tooltip_ability_remote_mine_lua"	"Remote Mine"
"DOTA_Tooltip_ability_remote_mine_lua_damage"	"DAMAGE:"
"[english]DOTA_Tooltip_ability_remote_mine_lua_damage"	"DAMAGE:"
"DOTA_Tooltip_ability_proximity_mine_lua_damage"	"DAMAGE:"
"[english]DOTA_Tooltip_ability_proximity_mine_lua_damage"	"DAMAGE:"
"DOTA_Tooltip_ability_stasis_trap_lua_stun_duration"	"DURATA NĂUCIRII:"
"[english]DOTA_Tooltip_ability_stasis_trap_lua_stun_duration"	"STUN DURATION:"
"DOTA_Tooltip_ability_stasis_trap_lua_stun_radius"	"RAZĂ NĂUCIRE:"
"[english]DOTA_Tooltip_ability_stasis_trap_lua_stun_radius"	"STUN RADIUS:"
"DOTA_Tooltip_ability_heartstopper_aura_lua_Description"	"Necrophos încetinește inimile adversarilor săi, cauzând unităților inamice din apropiere să primească damage în timp."
"[english]DOTA_Tooltip_ability_heartstopper_aura_lua_Description"	"Necrophos stills the hearts of his opponents, causing nearby enemy units to take damage over time."
"DOTA_Tooltip_ability_custom_shredder_whirling_death_duration"	"DURATĂ:"
"[english]DOTA_Tooltip_ability_custom_shredder_whirling_death_duration"	"DURATION:"
"DOTA_Tooltip_ability_custom_shredder_timber_chain"	"Shredder Timber Chain"
"[english]DOTA_Tooltip_ability_custom_shredder_timber_chain"	"Shredder Timber Chain"
"DOTA_Tooltip_ability_custom_shredder_timber_chain_range"	"DISTANȚĂ:"
"[english]DOTA_Tooltip_ability_custom_shredder_timber_chain_range"	"RANGE:"
"DOTA_Tooltip_ability_custom_shredder_timber_chain_radius"	"RAZĂ:"
"[english]DOTA_Tooltip_ability_custom_shredder_timber_chain_radius"	"RADIUS:"
"DOTA_Tooltip_ability_custom_shredder_timber_chain_speed"	"VITEZĂ:"
"[english]DOTA_Tooltip_ability_custom_shredder_timber_chain_speed"	"SPEED:"
"DOTA_Tooltip_ability_custom_shredder_timber_chain_damage"	"DAMAGE:"
"[english]DOTA_Tooltip_ability_custom_shredder_timber_chain_damage"	"DAMAGE:"
"DOTA_Tooltip_ability_custom_shredder_chakram_speed"	"VITEZĂ:"
"[english]DOTA_Tooltip_ability_custom_shredder_chakram_speed"	"SPEED:"
"DOTA_Tooltip_ability_custom_shredder_chakram_radius"	"RAZĂ:"
"[english]DOTA_Tooltip_ability_custom_shredder_chakram_radius"	"RADIUS:"
"DOTA_Tooltip_ability_custom_puck_phase_shift_duration"	"DURATĂ:"
"[english]DOTA_Tooltip_ability_custom_puck_phase_shift_duration"	"DURATION:"
"DOTA_Tooltip_ability_ogre_tank_melee_smash_impact_radius"	"RAZĂ IMPACT:"
"[english]DOTA_Tooltip_ability_ogre_tank_melee_smash_impact_radius"	"IMPACT RADIUS:"
"DOTA_Tooltip_ability_ogre_tank_melee_smash_stun_duration"	"DURATA NĂUCIRII:"
"[english]DOTA_Tooltip_ability_ogre_tank_melee_smash_stun_duration"	"STUN DURATION:"
"DOTA_Tooltip_ability_ogre_tank_melee_smash_damage"	"DAMAGE:"
"[english]DOTA_Tooltip_ability_ogre_tank_melee_smash_damage"	"DAMAGE:"
"DOTA_Tooltip_ability_ogre_tank_jump_smash_impact_radius"	"RAZĂ IMPACT:"
"[english]DOTA_Tooltip_ability_ogre_tank_jump_smash_impact_radius"	"IMPACT RADIUS:"
"DOTA_Tooltip_ability_ogre_tank_jump_smash_stun_duration"	"DURATA NĂUCIRII:"
"[english]DOTA_Tooltip_ability_ogre_tank_jump_smash_stun_duration"	"STUN DURATION:"
"DOTA_Tooltip_ability_ogre_tank_jump_smash_damage"	"DAMAGE:"
"[english]DOTA_Tooltip_ability_ogre_tank_jump_smash_damage"	"DAMAGE:"
"DOTA_Tooltip_ability_ogre_tank_boss_melee_smash_impact_radius"	"RAZĂ IMPACT:"
"[english]DOTA_Tooltip_ability_ogre_tank_boss_melee_smash_impact_radius"	"IMPACT RADIUS:"
"DOTA_Tooltip_ability_ogre_tank_boss_melee_smash_stun_duration"	"DURATA NĂUCIRII:"
"[english]DOTA_Tooltip_ability_ogre_tank_boss_melee_smash_stun_duration"	"STUN DURATION:"
"DOTA_Tooltip_ability_ogre_tank_boss_melee_smash_damage"	"DAMAGE:"
"[english]DOTA_Tooltip_ability_ogre_tank_boss_melee_smash_damage"	"DAMAGE:"
"DOTA_Tooltip_ability_ogre_tank_boss_jump_smash_impact_radius"	"RAZĂ IMPACT:"
"[english]DOTA_Tooltip_ability_ogre_tank_boss_jump_smash_impact_radius"	"IMPACT RADIUS:"
"DOTA_Tooltip_ability_ogre_tank_boss_jump_smash_stun_duration"	"DURATA NĂUCIRII:"
"[english]DOTA_Tooltip_ability_ogre_tank_boss_jump_smash_stun_duration"	"STUN DURATION:"
"DOTA_Tooltip_ability_ogre_tank_boss_jump_smash_damage"	"DAMAGE:"
"[english]DOTA_Tooltip_ability_ogre_tank_boss_jump_smash_damage"	"DAMAGE:"
"DOTA_Tooltip_ability_deafening_blast_passive"	"Deafening Blast"
"[english]DOTA_Tooltip_ability_deafening_blast_passive"	"Deafening Blast"
"DOTA_Tooltip_ability_invoker_leader_tornado"	"Tornado"
"[english]DOTA_Tooltip_ability_invoker_leader_tornado"	"Tornado"
"DOTA_Tooltip_ability_invoker_leader_deafening_blast"	"Deafening Blast"
"[english]DOTA_Tooltip_ability_invoker_leader_deafening_blast"	"Deafening Blast"
"DOTA_Tooltip_ability_invoker_leader_sunstrike"	"Sunstrike"
"[english]DOTA_Tooltip_ability_invoker_leader_sunstrike"	"Sunstrike"
"DOTA_Tooltip_ability_invoker_leader_sunstrike_delay"	"ÎNTÂRZIERE:"
"[english]DOTA_Tooltip_ability_invoker_leader_sunstrike_delay"	"DELAY:"
"DOTA_Tooltip_ability_invoker_leader_sunstrike_area_of_effect"	"ARIA EFECTULUI:"
"[english]DOTA_Tooltip_ability_invoker_leader_sunstrike_area_of_effect"	"AREA OF EFFECT:"
"DOTA_Tooltip_ability_invoker_leader_ice_wall"	"Ice Wall"
"[english]DOTA_Tooltip_ability_invoker_leader_ice_wall"	"Ice Wall"
"DOTA_Tooltip_ability_invoker_leader_ice_wall_duration"	"DURATĂ:"
"[english]DOTA_Tooltip_ability_invoker_leader_ice_wall_duration"	"DURATION:"
"DOTA_Tooltip_ability_invoker_leader_emp"	"Emp"
"[english]DOTA_Tooltip_ability_invoker_leader_emp"	"Emp"
"DOTA_Tooltip_ability_invoker_leader_emp_delay"	"ÎNTÂRZIERE:"
"[english]DOTA_Tooltip_ability_invoker_leader_emp_delay"	"DELAY:"
"DOTA_Tooltip_ability_invoker_leader_emp_area_of_effect"	"ARIA EFECTULUI:"
"[english]DOTA_Tooltip_ability_invoker_leader_emp_area_of_effect"	"AREA OF EFFECT:"
"DOTA_Tooltip_ability_invoker_leader_alacrity"	"Alacrity"
"[english]DOTA_Tooltip_ability_invoker_leader_alacrity"	"Alacrity"
"DOTA_Tooltip_ability_invoker_leader_alacrity_bonus_attack_speed"	"VITEZĂ DE ATAC BONUS:"
"[english]DOTA_Tooltip_ability_invoker_leader_alacrity_bonus_attack_speed"	"BONUS ATTACK SPEED:"
"DOTA_Tooltip_ability_invoker_leader_alacrity_bonus_damage"	"DAMAGE BONUS:"
"[english]DOTA_Tooltip_ability_invoker_leader_alacrity_bonus_damage"	"BONUS DAMAGE:"
"DOTA_Tooltip_ability_invoker_leader_alacrity_duration"	"DURATĂ:"
"[english]DOTA_Tooltip_ability_invoker_leader_alacrity_duration"	"DURATION:"
"DOTA_Tooltip_ability_invoker_leader_forge_spirit"	"Forge Spirit"
"[english]DOTA_Tooltip_ability_invoker_leader_forge_spirit"	"Forge Spirit"
"DOTA_Tooltip_ability_invoker_leader_forge_spirit_duration"	"DURATĂ:"
"[english]DOTA_Tooltip_ability_invoker_leader_forge_spirit_duration"	"DURATION:"
"DOTA_Tooltip_ability_invoker_leader_cold_snap"	"Cold Snap"
"[english]DOTA_Tooltip_ability_invoker_leader_cold_snap"	"Cold Snap"
"DOTA_Tooltip_ability_invoker_leader_cold_snap_duration"	"DURATĂ:"
"[english]DOTA_Tooltip_ability_invoker_leader_cold_snap_duration"	"DURATION:"
"DOTA_Tooltip_ability_invoker_leader_invoke"	"Invoke"
"[english]DOTA_Tooltip_ability_invoker_leader_invoke"	"Invoke"
"DOTA_Tooltip_ability_tombstone_spawn_zombies_lua"	"Spawn Zombies"
"[english]DOTA_Tooltip_ability_tombstone_spawn_zombies_lua"	"Spawn Zombies"
"DOTA_Tooltip_ability_tombstone_spawn_zombies_lua_spawn_delay"	"ÎNTÂRZIEREA ÎNVIERII:"
"[english]DOTA_Tooltip_ability_tombstone_spawn_zombies_lua_spawn_delay"	"SPAWN DELAY:"
"DOTA_Tooltip_ability_sniper_ground_shot_lua"	"Ground Shot"
"[english]DOTA_Tooltip_ability_sniper_ground_shot_lua"	"Ground Shot"
"DOTA_Tooltip_ability_sniper_ground_shot_lua_damage"	"DAMAGE:"
"[english]DOTA_Tooltip_ability_sniper_ground_shot_lua_damage"	"DAMAGE:"
"DOTA_Tooltip_ability_furion_teleport_lua"	"Teleport"
"[english]DOTA_Tooltip_ability_furion_teleport_lua"	"Teleport"
"DOTA_Tooltip_ability_greater_bash_lua_damage"	"DAMAGE:"
"[english]DOTA_Tooltip_ability_greater_bash_lua_damage"	"DAMAGE:"
"DOTA_Tooltip_ability_arcane_bolt_lua_damage"	"DAMAGE:"
"[english]DOTA_Tooltip_ability_arcane_bolt_lua_damage"	"DAMAGE:"
"DOTA_Tooltip_ability_custom_boar_poison_attack_speed"	"VITEZĂ DE ATAC:"
"[english]DOTA_Tooltip_ability_custom_boar_poison_attack_speed"	"ATTACK SPEED:"
"DOTA_Tooltip_ability_custom_boar_poison_movement_speed"	"VITEZĂ DE MIŞCARE:"
"[english]DOTA_Tooltip_ability_custom_boar_poison_movement_speed"	"MOVEMENT SPEED:"
"DOTA_Tooltip_ability_custom_boar_poison_duration"	"DURATĂ:"
"[english]DOTA_Tooltip_ability_custom_boar_poison_duration"	"DURATION:"
"DOTA_Tooltip_ability_lone_druid_rabid_lua_bonus_move_speed"	"VITEZĂ DE MIȘCARE BONUS:"
"[english]DOTA_Tooltip_ability_lone_druid_rabid_lua_bonus_move_speed"	"BONUS MOVE SPEED:"
"DOTA_Tooltip_ability_lone_druid_rabid_lua_bonus_attack_speed"	"VITEZĂ DE ATAC BONUS:"
"[english]DOTA_Tooltip_ability_lone_druid_rabid_lua_bonus_attack_speed"	"BONUS ATTACK SPEED:"
"DOTA_Tooltip_ability_lone_druid_rabid_lua_duration"	"DURATĂ:"
"[english]DOTA_Tooltip_ability_lone_druid_rabid_lua_duration"	"DURATION:"
"DOTA_Tooltip_ability_custom_entangling_roots_Description"	"Atacurile au o șansă de a cauza să izbucnească rădăcini din pământ, imobilizând unitatea inamică atacată și provocându-i damage pe secundă."
"[english]DOTA_Tooltip_ability_custom_entangling_roots_Description"	"Attacks have a chance to cause roots to burst from the ground, immobilizing the attacked enemy unit, and dealing damage per second."
"DOTA_Tooltip_ability_custom_entangling_roots_hero_duration"	"DURATĂ:"
"[english]DOTA_Tooltip_ability_custom_entangling_roots_hero_duration"	"DURATION:"
"DOTA_Tooltip_ability_place_land_mine_lua_damage"	"DAMAGE:"
"[english]DOTA_Tooltip_ability_place_land_mine_lua_damage"	"DAMAGE:"
"DOTA_Tooltip_ability_custom_overpower_Description"	"Folosindu-și îndemânarea sa în luptă, Ursa primește viteză de atac sporită pentru un număr de atacuri viitoare."
"[english]DOTA_Tooltip_ability_custom_overpower_Description"	"Using his skill in combat, Ursa gains increased attack speed for a number of subsequent attacks."
"DOTA_Tooltip_ability_custom_overpower_max_attacks"	"NUMĂR MAXIM DE ATACURI:"
"[english]DOTA_Tooltip_ability_custom_overpower_max_attacks"	"MAX ATTACKS:"
"DOTA_Tooltip_ability_custom_overpower_duration_tooltip"	"DURATĂ:"
"[english]DOTA_Tooltip_ability_custom_overpower_duration_tooltip"	"DURATION:"
"DOTA_Tooltip_ability_custom_fury_swipes_Description"	"Ghearele lui Ursa cauzează răni din ce în ce mai adânci în inamic, făcând ca atacurile consecutive asupra aceluiași inamic să cauzeze mai mult damage. Dacă aceeași țintă nu e atacată după 15 secunde, bonusul de damage se pierde."
"[english]DOTA_Tooltip_ability_custom_fury_swipes_Description"	"Ursa's claws dig deeper wounds in the enemy, causing consecutive attacks to the same enemy to deal more damage."
"DOTA_Tooltip_ability_place_propulsion_mine_lua_tooltip_damage"	"DAMAGE:"
"[english]DOTA_Tooltip_ability_place_propulsion_mine_lua_tooltip_damage"	"DAMAGE:"
"DOTA_Tooltip_ability_propulsion_mine_lua_damage"	"DAMAGE:"
"[english]DOTA_Tooltip_ability_propulsion_mine_lua_damage"	"DAMAGE:"
"DOTA_Tooltip_ability_propulsion_mine_lua_radius"	"RAZĂ:"
"[english]DOTA_Tooltip_ability_propulsion_mine_lua_radius"	"RADIUS:"
"DOTA_Tooltip_ability_breathe_fire_range"	"DISTANȚĂ:"
"[english]DOTA_Tooltip_ability_breathe_fire_range"	"RANGE:"
"DOTA_Tooltip_ability_breathe_fire_speed"	"VITEZĂ:"
"[english]DOTA_Tooltip_ability_breathe_fire_speed"	"SPEED:"
"DOTA_Tooltip_ability_custom_cold_feet_Description"	"Aplică un blestem înghețat care provoacă damage în timp pe o unitate inamică, dar poate fi descântat prin deplasarea departe de punctul inițial de invocare. Dacă unitatea inamică nu se mișcă în afara razei date, va fi năucită și înghețată în loc."
"[english]DOTA_Tooltip_ability_custom_cold_feet_Description"	"Places a frozen hex on an enemy unit that deals damage over time, but can be dispelled by moving away from the initial cast point. If the enemy unit doesn't move out of the given range, it will be stunned and frozen in place."
"DOTA_Tooltip_ability_custom_cold_feet_damage"	"DAMAGE:"
"[english]DOTA_Tooltip_ability_custom_cold_feet_damage"	"DAMAGE:"
"DOTA_Tooltip_ability_custom_cold_feet_stun_duration"	"DURATĂ NĂUCIRE:"
"[english]DOTA_Tooltip_ability_custom_cold_feet_stun_duration"	"STUN DURATION:"
"DOTA_Tooltip_ability_custom_cold_feet_cast_range_tooltip"	"DISTANȚĂ DE INVOCARE:"
"[english]DOTA_Tooltip_ability_custom_cold_feet_cast_range_tooltip"	"CAST RANGE:"
"DOTA_Tooltip_ability_custom_ice_vortex"	"Ice Vortex"
"[english]DOTA_Tooltip_ability_custom_ice_vortex"	"Ice Vortex"
"DOTA_Tooltip_ability_custom_ice_vortex_Description"	"Creează un vârtej de energie înghețată ce încetinește viteza de mișcare și mărește damage-ul magic cauzat în raza sa."
"[english]DOTA_Tooltip_ability_custom_ice_vortex_Description"	"Creates a vortex of icy energy that slows movement speed and increases magic damage done in its range."
"DOTA_Tooltip_ability_custom_ice_vortex_radius"	"RAZĂ:"
"[english]DOTA_Tooltip_ability_custom_ice_vortex_radius"	"RADIUS:"
"DOTA_Tooltip_ability_custom_ice_vortex_movement_speed_pct"	"VITEZĂ DE MIŞCARE:"
"[english]DOTA_Tooltip_ability_custom_ice_vortex_movement_speed_pct"	"MOVEMENT SPEED:"
"DOTA_Tooltip_ability_whirling_death_lua"	"Whirling Death"
"[english]DOTA_Tooltip_ability_whirling_death_lua"	"Whirling Death"
"DOTA_Tooltip_ability_whirling_death_lua_whirling_radius"	"RAZĂ:"
"[english]DOTA_Tooltip_ability_whirling_death_lua_whirling_radius"	"RADIUS:"
"DOTA_Tooltip_ability_timber_chain_lua"	"Timber Chain"
"[english]DOTA_Tooltip_ability_timber_chain_lua"	"Timber Chain"
"DOTA_Tooltip_ability_timber_chain_lua_range"	"DISTANȚĂ:"
"[english]DOTA_Tooltip_ability_timber_chain_lua_range"	"RANGE:"
"DOTA_Tooltip_ability_chakram_lua_speed"	"VITEZĂ:"
"[english]DOTA_Tooltip_ability_chakram_lua_speed"	"SPEED:"
"DOTA_Tooltip_ability_chakram_return_lua"	"Chakram Return"
"[english]DOTA_Tooltip_ability_chakram_return_lua"	"Chakram Return"
"DOTA_Tooltip_ability_containers_lua_targeting_Description"	"
"
"[english]DOTA_Tooltip_ability_containers_lua_targeting_Description"	""
"DOTA_Tooltip_ability_barebones_empty1"	"Barebones Empty1"
"[english]DOTA_Tooltip_ability_barebones_empty1"	"Barebones Empty1"
"DOTA_Tooltip_ability_barebones_empty2"	"Barebones Empty2"
"[english]DOTA_Tooltip_ability_barebones_empty2"	"Barebones Empty2"
"DOTA_Tooltip_ability_barebones_empty3"	"Barebones Empty3"
"[english]DOTA_Tooltip_ability_barebones_empty3"	"Barebones Empty3"
"DOTA_Tooltip_ability_barebones_empty4"	"Barebones Empty4"
"[english]DOTA_Tooltip_ability_barebones_empty4"	"Barebones Empty4"
"DOTA_Tooltip_ability_barebones_empty5"	"Barebones Empty5"
"[english]DOTA_Tooltip_ability_barebones_empty5"	"Barebones Empty5"
"DOTA_Tooltip_ability_barebones_empty6"	"Barebones Empty6"
"[english]DOTA_Tooltip_ability_barebones_empty6"	"Barebones Empty6"
"DOTA_Tooltip_ability_item_rune_heal"	"Regenerare"
"[english]DOTA_Tooltip_ability_item_rune_heal"	"Regeneration"
"DOTA_Tooltip_ability_item_rune_heal_heal"	"VINDECARE:"
"[english]DOTA_Tooltip_ability_item_rune_heal_heal"	"HEAL:"
"DOTA_Tooltip_ability_item_rune_full_heal"	"Regenerare"
"[english]DOTA_Tooltip_ability_item_rune_full_heal"	"Regeneration"
"DOTA_Tooltip_ability_item_rune_full_heal_heal"	"VINDECARE:"
"[english]DOTA_Tooltip_ability_item_rune_full_heal_heal"	"HEAL:"
"DOTA_Tooltip_ability_item_rune_double_damage_duration"	"DURATĂ:"
"[english]DOTA_Tooltip_ability_item_rune_double_damage_duration"	"DURATION:"
"DOTA_Tooltip_ability_item_blink_lua"	"Blink Dagger"
"[english]DOTA_Tooltip_ability_item_blink_lua"	"Blink Dagger"
"DOTA_Tooltip_ability_item_blink_lua_blink_range"	"DISTANȚĂ BLINK:"
"[english]DOTA_Tooltip_ability_item_blink_lua_blink_range"	"BLINK RANGE:"
"DOTA_Tooltip_ability_item_rune_haste"	"Haste"
"[english]DOTA_Tooltip_ability_item_rune_haste"	"Haste"
"DOTA_Tooltip_ability_item_rune_haste_duration"	"DURATĂ:"
"[english]DOTA_Tooltip_ability_item_rune_haste_duration"	"DURATION:"
"DOTA_Tooltip_ability_item_rune_double_damage"	"Damage dublu"
"[english]DOTA_Tooltip_ability_item_rune_double_damage"	"Double Damage"
"DOTA_Frostivus_2017_Suicidal_Axe_Name"	"Suicidal Axe"
"[english]DOTA_Frostivus_2017_Suicidal_Axe_Name"	"Suicidal Axe"
"DOTA_Frostivus_2017_Suicidal_Pudge_Name"	"Suicidal Pudge"
"[english]DOTA_Frostivus_2017_Suicidal_Pudge_Name"	"Suicidal Pudge"
"DOTA_Frostivus_2017_Chain_Frost_Tag_Name"	"Leapșa Chain Frost"
"[english]DOTA_Frostivus_2017_Chain_Frost_Tag_Name"	"Chain Frost Tag"
"DOTA_Frostivus_2017_Minefield_Survival_Name"	"Supraviețuire în câmpul minat"
"[english]DOTA_Frostivus_2017_Minefield_Survival_Name"	"Minefield Survival"
"DOTA_Frostivus_2017_Minefield_Racing_Name"	"Curse prin câmp minat"
"[english]DOTA_Frostivus_2017_Minefield_Racing_Name"	"Minefield Racing"
"DOTA_Frostivus_2017_Arrow_Practice_Name"	"Antrenament cu săgeți"
"[english]DOTA_Frostivus_2017_Arrow_Practice_Name"	"Arrow Practice"
"DOTA_Frostivus_2017_Survive_the_Winter_Name"	"Supraviețuiește iernii"
"[english]DOTA_Frostivus_2017_Survive_the_Winter_Name"	"Survive the Winter"
"DOTA_Frostivus_2017_Pudge_Wars_Name"	"Război între Pudge"
"[english]DOTA_Frostivus_2017_Pudge_Wars_Name"	"Pudge Wars"
"DOTA_Frostivus_2017_Shadowfiend_Wars_Name"	"Război între Shadowfiend"
"[english]DOTA_Frostivus_2017_Shadowfiend_Wars_Name"	"Shadowfiend Wars"
"DOTA_Frostivus_2017_Monkey_Mischief_Name"	"Maimuțăreli"
"[english]DOTA_Frostivus_2017_Monkey_Mischief_Name"	"Monkey Mischief"
"DOTA_Frostivus_2017_Kaolin_Soccer_Name"	"Fotbal Kaolin"
"[english]DOTA_Frostivus_2017_Kaolin_Soccer_Name"	"Kaolin Soccer"
"DOTA_Frostivus_2017_Boar_Bear_Hawk_Name"	"Mistreț, Urs, Șoim"
"[english]DOTA_Frostivus_2017_Boar_Bear_Hawk_Name"	"Boar, Bear, Hawk"
"DOTA_Frostivus_2017_Archer_Wars_Name"	"Război între arcași"
"[english]DOTA_Frostivus_2017_Archer_Wars_Name"	"Archer Wars"
"DOTA_Frostivus_2017_Ogre_Seal_Survival_Name"	"Supraviețuirea focii Ogre"
"[english]DOTA_Frostivus_2017_Ogre_Seal_Survival_Name"	"Ogre Seal Survival"
"DOTA_Frostivus_2017_Ogre_Survival_Name"	"Supraviețuirea focii Ogre"
"[english]DOTA_Frostivus_2017_Ogre_Survival_Name"	"Ogre Survival"
"DOTA_Frostivus_2017_Red_Light_Green_Light_Name"	"Lumina roșie, lumina verde"
"[english]DOTA_Frostivus_2017_Red_Light_Green_Light_Name"	"Red Light, Green Light"
"DOTA_Frostivus_2017_Spirit_Breaker_Race_Name"	"Cursă cu Spirit Breaker"
"[english]DOTA_Frostivus_2017_Spirit_Breaker_Race_Name"	"Spirit Breaker Race"
"DOTA_Frostivus_2017_Zombies_Zombies_Zombies_Name"	"Zombie Zombie Zombie"
"[english]DOTA_Frostivus_2017_Zombies_Zombies_Zombies_Name"	"Zombies Zombies Zombies"
"DOTA_Frostivus_2017_Poke_the_Ogre_Name"	"Împunge Ogre-ul"
"[english]DOTA_Frostivus_2017_Poke_the_Ogre_Name"	"Poke the Ogre"
"DOTA_Frostivus_2017_Follow_the_Leader_Name"	"Urmează liderul"
"[english]DOTA_Frostivus_2017_Follow_the_Leader_Name"	"Follow the Leader"
"DOTA_Frostivus_2017_Coin_Collection_Name"	"Colecție de monede"
"[english]DOTA_Frostivus_2017_Coin_Collection_Name"	"Coin Collection"
"DOTA_Frostivus_2017_Spirit_Breaker_Sumo_Name"	"Sumo cu Spirit Breaker"
"[english]DOTA_Frostivus_2017_Spirit_Breaker_Sumo_Name"	"Spirit Breaker Sumo"
"DOTA_Frostivus_2017_Refraction_Survival_Name"	"Supraviețuirea refracției"
"[english]DOTA_Frostivus_2017_Refraction_Survival_Name"	"Refraction Survival"
"DOTA_Frostivus_2017_Campfire_Survival_Name"	"Supraviețuire la foc de tabără"
"[english]DOTA_Frostivus_2017_Campfire_Survival_Name"	"Campfire Survival"
"DOTA_Frostivus_2017_Impetus_Throwing_Contest_Name"	"Aruncare la distanță cu Impetus"
"[english]DOTA_Frostivus_2017_Impetus_Throwing_Contest_Name"	"Impetus Throwing Contest"
"DOTA_Frostivus_2017_Techies_Knockout_Name"	"Knockout cu Techies"
"[english]DOTA_Frostivus_2017_Techies_Knockout_Name"	"Techies Knockout"
"DOTA_Frostivus_2017_Fire_Trap_Race_Name"	"Cursă cu capcane de foc"
"[english]DOTA_Frostivus_2017_Fire_Trap_Race_Name"	"Fire Trap Race"
"DOTA_Frostivus_2017_Avalanche_Survival_Name"	"Supraviețuirea avalanșei"
"[english]DOTA_Frostivus_2017_Avalanche_Survival_Name"	"Avalanche Survival"
"DOTA_Frostivus_2017_An_End_To_All_Magic_Name"	"An End To All Magic"
"[english]DOTA_Frostivus_2017_An_End_To_All_Magic_Name"	"An End To All Magic"
"DOTA_Frostivus_2017_Deforestation_Name"	"Defrișare"
"[english]DOTA_Frostivus_2017_Deforestation_Name"	"Deforestation"
"DOTA_Frostivus2017_Coin_Collection_Desc"	"Colectează cele mai multe monede înainte ca timpul să se scurgă"
"[english]DOTA_Frostivus2017_Coin_Collection_Desc"	"Collect the most coins before time runs out"
}
}
