"dota"
{
"InfoScreenClose"	"Продовжити"
"[english]InfoScreenClose"	"Continue"
"EndScreenClose"	"Вийти"
"[english]EndScreenClose"	"Exit"
"basics_alert_TowerDamageTitle"	"Нас атакують!"
"[english]basics_alert_TowerDamageTitle"	"Incoming Fire!"
"basics_alert_TowerDamageBody"	"Ворожі вежі завдають багато шкоди. Відступайте!"
"[english]basics_alert_TowerDamageBody"	"Enemy Towers deal a lot of damage. Retreat!"
"basics_alert_UseTangoTitle"	"Лікування"
"[english]basics_alert_UseTangoTitle"	"Healing"
"basics_alert_UseTangoBody"	"Намагайтесь використовувати Tango, щоб мати повне здоров’я."
"[english]basics_alert_UseTangoBody"	"Try using a Tango to keep your health full."
"basics_alert_UseSalveTitle"	"Важкі ушкодження"
"[english]basics_alert_UseSalveTitle"	"Heavy Damage"
"basics_alert_UseSalveBody"	"Використайте Salve для лікування. Отримання шкоди зупинить дію лікування."
"[english]basics_alert_UseSalveBody"	"Use a Salve to heal. Taking damage will cancel the healing effect."
"basics_alert_UseClarityTitle"	"Відновити ману"
"[english]basics_alert_UseClarityTitle"	"Restore Mana"
"basics_alert_UseClarityBody"	"Використайте Clarity, щоб відновити ману. Отримання шкоди зупинить дію відновлення."
"[english]basics_alert_UseClarityBody"	"Use a Clarity to restore mana. Taking damage will cancel the restoring effect."
"basics_alert_FirstDeathTitle"	"Смерть: вартість та відродження"
"[english]basics_alert_FirstDeathTitle"	"Death: Costs & Respawning"
"basics_alert_FirstDeathBody"	"Коли ви помираєте, то втрачаєте частину вашого золота, а герой чи герої, які причетні до вашої смерті, отримують досвід і стають сильнішими.\n\nВи відродитесь біля фонтану вашої команди, коли мине час смерті. Ви можете побачити час смерті біля іконок героїв у верхній частині екрану."
"[english]basics_alert_FirstDeathBody"	"When you die, you will lose a portion of your gold, and the hero or heroes responsible for your death earn experience to become stronger.\n\nYou will respawn at your team's fountain when your death timer ends. You can see your death timer beneath your hero's portrait at the top of the screen."
"basics_alert_SecondDeathTitle"	"Смерть: відступ під час небезпеки"
"[english]basics_alert_SecondDeathTitle"	"Death: Retreat When in Danger"
"basics_alert_SecondDeathBody"	"Подбайте про розташування свого героя. Якщо ворожа вежа, герой чи кріп почнуть вас атакувати, сплануйте відступ.\n\nЗ кожним рівнем тривалість смерті героя збільшується."
"[english]basics_alert_SecondDeathBody"	"Take care where you place your hero. If a Tower, hero, or enemy creep begins attacking you, consider retreating.\n\nEach level gained increases how long a hero remains dead."
"basics_alert_RespawnTitle"	"Скоро відродитеся"
"[english]basics_alert_RespawnTitle"	"Respawning Soon"
"basics_alert_RespawnBody"	"Незабаром ваш герой відродиться біля фонтану вашої команди.\n\nНамагайтеся якомога швидше повернутися у бій!"
"[english]basics_alert_RespawnBody"	"Your hero will respawn at your team's fountain in a moment.\n\nTry to get back into battle quickly!"
"basics_alert_TangoUsageTitle"	"Використання Tango"
"[english]basics_alert_TangoUsageTitle"	"Using a Tango"
"basics_alert_TangoUsageBody"	"За допомогою Tango ви можете з’їсти дерево і відновити невелику кількість здоров’я протягом певного часу.\n\nВи вже активували Tango, натиснувши на його іконку чи кнопку. Тепер натисніть лівою кнопкою миші по дереву, щоб використати Tango."
"[english]basics_alert_TangoUsageBody"	"A Tango allows you to consume a tree to restore a small amount of health over time.\n\nYou have already activated the Tango, either by clicking on its icon, or pressing its key. Now, left-click on a tree to use a Tango."
"basics_alert_SalveUsageTitle"	"Використання Healing Salve"
"[english]basics_alert_SalveUsageTitle"	"Using a Healing Salve"
"basics_alert_SalveUsageBody"	"Healing Salves може швидко вилікувати вас або дружнього героя (ЛКМ).\n\nОтримання шкоди зупинить дію лікування."
"[english]basics_alert_SalveUsageBody"	"Healing Salves can quickly heal the hero you target (left-click).\n\nTaking damage will cancel the healing effect."
"basics_alert_ClarityUsageTitle"	"Використання Clarity"
"[english]basics_alert_ClarityUsageTitle"	"Using a Clarity"
"basics_alert_ClarityUsageBody"	"Зілля Clarity повільно відновлює ману вам або дружньому герою.\n\nОтримання шкоди зупинить відновлення."
"[english]basics_alert_ClarityUsageBody"	"The Clarity potion slowly regenerates mana on the hero you target.\n\nTaking damage will cancel the regenerating effect."
"basics_ExcessiveTowerDamageTitle"	"Вежі небезпечні. Відступаємо!"
"[english]basics_ExcessiveTowerDamageTitle"	"Towers are Dangerous. Retreat!"
"basics_ExcessiveTowerDamageBody"	"Ай! Ви отримали забагато шкоди від вежі!\n\nВідходьте, поки вежа не почне атакувати когось іншого."
"[english]basics_ExcessiveTowerDamageBody"	"Ouch! You are taking a lot of damage from the Tower!\n\nBack up until the Tower begins to attack something else."
"basics_objective_CloseShopTitle"	"Закрити крамницю (ЛКМ)"
"[english]basics_objective_CloseShopTitle"	"Close the Shop (left-click)"
"basics_objective_CloseShopBody"	"Натисніть на кнопку КРАМ, щоб закрити крамницю."
"[english]basics_objective_CloseShopBody"	"Click the Shop button again to close the shop."
"basics_objective_BackToCombatTitle"	"Повернення на центральну лінію"
"[english]basics_objective_BackToCombatTitle"	"Return to the Middle Lane"
"basics_objective_BackToCombatBody"	"Ось де справжнє навчання!"
"[english]basics_objective_BackToCombatBody"	"That's where the tutorial is!"
"basics_HeroIntroTitle"	"Ваш герой та ваша команда"
"[english]basics_HeroIntroTitle"	"Your Hero & Your Team"
"basics_HeroIntroBody"	"Ласкаво просимо до Dota! Тут ми навчимо вас основам.\n\nВи контролюватимете Luna, спритного героя, яка кидає у ворогів ножі із короткої відстані та завдає шкоду променями з неба. Ви будете грати за команду Сяйва проти ворожої команди Пітьми."
"[english]basics_HeroIntroBody"	"Welcome to Dota! In this tutorial, we will teach you the basics.\n\nYou will be controlling Luna, a swift hero who throws blades at her enemies from a short distance, and summons damaging beams from the sky. You will be playing for the Radiant team, against the enemy Dire team."
"basics_FountainIntroTitle"	"Фонтан: джерело лікування"
"[english]basics_FountainIntroTitle"	"The Fountain: A Source of Healing"
"basics_FountainIntroBody"	"На початку кожного матчу ваш герой з’являється біля фонтану вашої команди. Якщо ви загинули, то тут ви відродитеся.\n\nПоруч з фонтаном вашої команди ви швидко відновлюватимете здоров’я та ману."
"[english]basics_FountainIntroBody"	"Your hero begins each match at your team's fountain. If you fall in battle, you will respawn here as well.\n\nBeing near your team's fountain will quickly restore your health and mana."
"basics_MovingYourHeroTitle"	"Основи керування героєм та камерою"
"[english]basics_MovingYourHeroTitle"	"Basic Hero & Camera Controls"
"basics_MovingYourHeroBody"	"Команди пересування та атаки виконуються клацанням ПКМ на місце, куди має піти герой, чи на ціль, яку він має атакувати.\n\nКамеру можна пересувати підведенням курсору миші до краю екрана. У будь-який час ви можете центрувати камеру на вашому герої, натиснувши {g:dota_key:keyname}."
"[english]basics_MovingYourHeroBody"	"Movement and attack commands are issued by right-clicking where you would like them to go, or on what you would like them to attack.\n\nThe camera view can be moved by touching your mouse cursor to the edge of the screen. At any time, you may center the view on your hero by pressing {g:dota_key:keyname}."
"basics_objective_MoveToAncientTitle"	"Рухайтесь до вашого Древнього"
"[english]basics_objective_MoveToAncientTitle"	"Move to your Ancient"
"basics_objective_MoveToAncientBody"	"Натисніть ПКМ для переміщення."
"[english]basics_objective_MoveToAncientBody"	"Right-click to move your hero."
"basics_AncientIntroTitle"	"Ваш Древній: захищайте його будь-якою ціною"
"[english]basics_AncientIntroTitle"	"Your Ancient: Defend It at All Costs"
"basics_AncientIntroBody"	"Це — Древній команди Сяйва, ваш Древній.\n\nВ Dota для перемоги ваша команда має знищити ворожого Древнього раніше, ніж ворог знищить вашого."
"[english]basics_AncientIntroBody"	"This is the Radiant team's Ancient, your Ancient.\n\nIn Dota, in order to win a match your team must destroy the enemy's Ancient before the enemy can destroy yours."
"basics_SpendGoldTitle"	"Завжди витрачайте початкове золото"
"[english]basics_SpendGoldTitle"	"Always Spend Your Starting Gold"
"basics_SpendGoldBody"	"На початку кожного матчу гравці отримують невелику суму початкового золота. Не забувайте завжди його витрачати на предмети із крамниці, перш ніж іти на поле бою.\n\nКрамниця знаходиться біля вашого фонтану. Перейдіть туди."
"[english]basics_SpendGoldBody"	"At the start of every match, players are given a small amount of starting gold. Always remember spend this gold on items from the shop before heading into the field.\n\nThe shop is available back at your team's fountain. Head there now."
"basics_objective_MoveToShopTitle"	"Поверніться до фонтану"
"[english]basics_objective_MoveToShopTitle"	"Return to the Fountain"
"basics_objective_MoveToShopBody"	"Рухайтесь (ПКМ) назад до крамниці біля фонтану."
"[english]basics_objective_MoveToShopBody"	"Move (right-click) back to the shop near the fountain."
"basics_objective_OpenShopTitle"	"Відкрийте крамницю"
"[english]basics_objective_OpenShopTitle"	"Open the Shop"
"basics_objective_OpenShopBody"	"Клацніть ЛКМ на кнопці «КРАМ» у нижній частині екрану, щоб відкрити крамницю."
"[english]basics_objective_OpenShopBody"	"Left-click the Shop button near the lower corner of your screen to open the shop."
"basics_BuyFromShopTitle"	"Крамниця: споряджайте вашого героя для перемоги"
"[english]basics_BuyFromShopTitle"	"The Shop: Equipping your Hero for Victory"
"basics_BuyFromShopBody"	"Предмети в Dota мають різні застосування. Деякі лікують, інші пасивно збільшують силу героя, а деякі навіть додають унікальні здібності.\n\nЗауважте, що крамниця показує бажані предмети для вашого героя. Ми рекомендуємо вам придбати предмети зі списку, поки ви новачок у Dota."
"[english]basics_BuyFromShopBody"	"Items have several uses in Dota. Some heal, others passively increase a hero's power, and some even provide unique abilities.\n\nNotice that the Shop displays a list of Suggested Items for your hero. We recommend that you purchase items from this list as you learn Dota."
"basics_objective_BuyTangoesTitle"	"Придбайте Tango"
"[english]basics_objective_BuyTangoesTitle"	"Purchase Tango"
"basics_objective_BuyTangoesBody"	"Клацніть ПКМ на Tango, щоб придбати його в крамниці."
"[english]basics_objective_BuyTangoesBody"	"Right-click the Tango item in the shop to purchase."
"basics_objective_BuySalveTitle"	"Придбайте Healing Salve"
"[english]basics_objective_BuySalveTitle"	"Purchase Healing Salve"
"basics_objective_BuySalveBody"	"Клацніть ПКМ на Healing Salve, щоб придбати його в крамниці."
"[english]basics_objective_BuySalveBody"	"Right-click the Healing Salve in the shop to purchase."
"basics_objective_BuyClarityTitle"	"Придбайте Clarity"
"[english]basics_objective_BuyClarityTitle"	"Purchase Clarity"
"basics_objective_BuyClarityBody"	"Натисніть у крамниці ПКМ на Clarity, щоб придбати його."
"[english]basics_objective_BuyClarityBody"	"Right-click the Clarity in the shop to purchase."
"basics_objective_BuyCircletTitle"	"Придбайте Circlet"
"[english]basics_objective_BuyCircletTitle"	"Purchase Circlet"
"basics_objective_BuyCircletBody"	"Натисніть у крамниці ПКМ на Circlet, щоб придбати його."
"[english]basics_objective_BuyCircletBody"	"Right-click the Circlet in the shop to purchase."
"basics_objective_BuySlippersTitle"	"Придбайте Slippers of Agility"
"[english]basics_objective_BuySlippersTitle"	"Purchase Slippers of Agility"
"basics_objective_BuySlippersBody"	"Клацніть ПКМ на Slippers of Agility, щоб придбати їх у крамниці."
"[english]basics_objective_BuySlippersBody"	"Right-click the Slippers of Agility in the shop to purchase."
"basics_BoughtStartingTitle"	"Початкові предмети: виживання на полі бою"
"[english]basics_BoughtStartingTitle"	"Starting Items: Surviving in the Field"
"basics_BoughtStartingBody"	"Деякі з ваших початкових предметів призначені для лікування та відновлення мани:\n— Tango: використовується, щоб з’їсти дерево та повільно лікуватись\n— Healing Salve: поволі відновлює велику кількість здоров’я\n— Clarity: повільно відновлює велику кількість мани\n\nПРИМІТКА: ефекти від Healing Salve та Clarity перериваються, якщо ви отримаєте шкоду."
"[english]basics_BoughtStartingBody"	"Some of your Starting Items can be consumed to heal or restore mana:\n- Tango: Use this to swallow a tree and slowly heal\n- Healing Salve: Gradually heals a large amount of health\n- Clarity: Slowly restores a large amount of mana\n\nNOTE: Healing Salve and Clarity's effects are cancelled if you are damaged."
"basics_LaneIntroTitle"	"Лінії: три шляхи атаки"
"[english]basics_LaneIntroTitle"	"Lanes: Three Paths of Attack"
"basics_LaneIntroBody"	"Поле бою перетинають 3 лінії, які з’єднують бази команд. Це верхня, центральна та нижня лінія."
"[english]basics_LaneIntroBody"	"There are three lanes that cross the battlefield, connecting the bases of both teams. These lanes are called Top, Middle, and Bottom."
"basics_objective_MoveToMidLaneTitle"	"Рухайтесь на середню лінію"
"[english]basics_objective_MoveToMidLaneTitle"	"Move to the Middle Lane"
"basics_objective_MoveToMidLaneBody"	"Рухайтесь (ПКМ) на середню лінію"
"[english]basics_objective_MoveToMidLaneBody"	"Move (right-click) to the Middle lane"
"basics_CreepsIntroTitle"	"Кріпи: піхотинці війни"
"[english]basics_CreepsIntroTitle"	"Creeps: Foot Soldiers of War"
"basics_CreepsIntroBody"	"Піхотинці вашої команди називаються кріпами. Вони з’являються на усіх лініях кожні 30 секунд.\n\nКріпи автоматично прямують до ворожої бази, атакуючи на своєму шляху кожну ворожу істоту чи будівлю."
"[english]basics_CreepsIntroBody"	"Your team's foot soldiers, called creeps, will spawn in each lane near the edge of your base every 30 seconds.\n\nCreeps automatically march toward the enemy base, attacking any enemy units or buildings they encounter."
"basics_LaningIntroTitle"	"Битва починається: йдіть за своїми кріпами"
"[english]basics_LaningIntroTitle"	"The Battle Begins: Follow Your Creeps"
"basics_LaningIntroBody"	"Скоро з’являться кріпи. Ідіть за ними в бій.\n\nРозташуйтесь так, щоб кріпи отримували всю шкоду від ворожих атак. Коли хвиля кріпів помре, поверніться та згрупуйтеся з іншою хвилею кріпів."
"[english]basics_LaningIntroBody"	"A wave of creeps is about to spawn. Follow them into combat.\n\nTry to position yourself so that the creeps receive any enemy attacks. When a wave of creeps dies, back up and regroup with the next creep wave."
"basics_objective_FollowCreepsTitle"	"Ідіть за вашими кріпами в бій"
"[english]basics_objective_FollowCreepsTitle"	"Follow your Creeps into battle"
"basics_objective_FollowCreepsBody"	"Рухайтесь (ПКМ) на середню лінію."
"[english]basics_objective_FollowCreepsBody"	"Move (right-click) into the Middle Lane."
"basics_AttackingIntroTitle"	"Атака: просто клацніть ПКМ по ворогу"
"[english]basics_AttackingIntroTitle"	"Attacking: Simply Right-Click an Enemy"
"basics_AttackingIntroBody"	"Атакуйте ворогів, клацнувши на них ПКМ.\n\nЯкщо ви починаєте бити ворога, то ваш герой битиме, допоки ворог не помре, або поки ви не почнете виконувати іншу дію."
"[english]basics_AttackingIntroBody"	"Attack enemy units by right-clicking on them.\n\nOnce you begin attacking an enemy, your hero will continue attacking until the enemy dies, or until you perform another action."
"basics_BountiesIntroTitle"	"Останні удари: заробляйте золото швидко"
"[english]basics_BountiesIntroTitle"	"Last Hits: Earn Gold Quickly"
"basics_BountiesIntroBody"	"Кожного разу, коли ви завдаєте останнього удару по ворогу, ви заробляєте додаткові гроші. Це і зветься останніми ударами.\n\nАтакуйте ворога, коли в нього мало здоров’я, щоб добити його останнім ударом."
"[english]basics_BountiesIntroBody"	"Whenever you strike the killing blow on an enemy, you will earn an additional bounty of gold. This is called a Last Hit.\n\nAttack enemy units whose health is low to earn a Last Hit now."
"basics_objective_LastHitCreepsTitle"	"Заробіть гроші"
"[english]basics_objective_LastHitCreepsTitle"	"Earn a Bounty"
"basics_objective_LastHitCreepsBody"	"Добийте ворога (ПКМ)."
"[english]basics_objective_LastHitCreepsBody"	"Strike the Last Hit on an enemy (right-click)."
"basics_ExpIntroTitle"	"Здобувайте досвід від боїв поблизу"
"[english]basics_ExpIntroTitle"	"Earning Experience from Nearby Battles"
"basics_ExpIntroBody"	"На відміну від золота, очки досвіду розподіляються між усіма героями поблизу, незалежно від останнього удару.\n\nЗдобуття досвіду та підвищення рівня дозволяє вам посилювати здібності вашого героя."
"[english]basics_ExpIntroBody"	"Unlike Last Hit bounties, experience points are shared between all nearby allied heroes whenever an enemy is slain.\n\nEarning experience points and gaining levels allows you to augment your hero's abilities."
"basics_objective_GetALevelTitle"	"Отримайте рівень"
"[english]basics_objective_GetALevelTitle"	"Gain a Level"
"basics_objective_GetALevelBody"	"Підвищуйте рівень вашого героя, допомагаючи вбивати ворожих істот."
"[english]basics_objective_GetALevelBody"	"Level up your hero by helping kill enemy units."
"basics_AbilityIntroTitle"	"Здібності: особлива сила вашого героя"
"[english]basics_AbilityIntroTitle"	"Abilities: Your Hero's Special Powers"
"basics_AbilityIntroBody"	"Коли ваш герой підвищує рівень, він отримує очко для вивчення нових або покращення вже вивчених здібностей.\n\nЗауважте, що ультимативну здібність — особливу здібність героя — можна вивчити лише на 6 рівні.\n\nНатисніть на золотій кнопці «+» над Lucent Beam, щоби вивчити здібність."
"[english]basics_AbilityIntroBody"	"Whenever a hero gains a level, they earn a point to spend toward learning, or strengthening, one of their abilities.\n\nNote that the Ultimate ability, which is a hero's signature power, cannot be learned until level 6.\n\nClick on the gold \"+\" button above Lucent Beam to learn that ability."
"basics_objective_LevelUpTitle"	"Новий рівень"
"[english]basics_objective_LevelUpTitle"	"Level Up"
"basics_objective_LevelUpBody"	"Клацніть ЛКМ на кнопці «+» над Lucent Beam."
"[english]basics_objective_LevelUpBody"	"Left-click the \"+\" button above Lucent Beam."
"basics_objective_BuyAbilityTitle"	"Вивчіть здібність"
"[english]basics_objective_BuyAbilityTitle"	"Learn an Ability"
"basics_objective_BuyAbilityBody"	"Клацніть ЛКМ на кнопці «+» над Lucent Beam, щоби вивчити цю здібність."
"[english]basics_objective_BuyAbilityBody"	"Left-click the \"+\" button above Lucent Beam to learn it."
"basics_HealYourselfTitle"	"Використання предметів: виберіть предмет, потім його ціль"
"[english]basics_HealYourselfTitle"	"Using Items: Select the Item, then its Target"
"basics_HealYourselfBody"	"Спробуйте використати Healing Salve, щоб вилікуватися. Спершу активуйте предмет, натиснувши кнопку іконки. Потім клацніть ЛКМ по своєму герою. Ви також можете натиснути двічі Healing Salve, щоб швидко використати його на собі.\n\nПРИМІТКА: дія Healing Salve буде скасована, якщо ви отримаєте шкоду!"
"[english]basics_HealYourselfBody"	"Try using a Healing Salve to heal yourself. First, activate the item by pressing the key above its icon. Then, left-click on your hero. You can also double-click the Healing Salve to immediately use it on yourself.\n\nNOTE: Healing Salve's effects will be cancelled if you are damaged!"
"basics_CastIntroTitle"	"Використання здібностей: активні і пасивні здібності"
"[english]basics_CastIntroTitle"	"Using Abilities: Activation and Passive Abilities"
"basics_CastIntroBody"	"Щоб використати здібність, спершу натисніть кнопку з іконкою здібності, а потім клацніть ЛКМ по цілі. Здібності, які потребують активації, витрачають ману.\n\nПасивні здібності, такі як «Lunar Blessing» у Luna, автоматичні, завжди активні і не потребують мани."
"[english]basics_CastIntroBody"	"To use an ability, first activate it by pressing the key shown above the ability's icon, then left-click on a target. Abilities which require activation cost mana to use.\n\nPassive abilities, such as Luna's Lunar Blessing, are automatic, always active, and do not require mana to function."
"basics_objective_CastSpellTitle"	"Використайте Lucent Beam"
"[english]basics_objective_CastSpellTitle"	"Use Lucent Beam"
"basics_objective_CastSpellBody"	"Натисніть {g:dota_key:keyname} для активації Lucent Beam, а потім клацніть ЛКМ по ворогу."
"[english]basics_objective_CastSpellBody"	"Press {g:dota_key:keyname} to activate Lucent Beam, then left-click on an enemy to cast."
"basics_AttackTowerTitle"	"Вежі: Відступайте, якщо атаковані"
"[english]basics_AttackTowerTitle"	"Towers: Retreat if Attacked"
"basics_AttackTowerBody"	"Вежі мають багато очок здоров’я та завдають ворогам значної шкоди. Зазвичай вони атакують найближчого ворога, допоки він не помре чи не відійде.\n\nЯкщо вежа атакує вашого героя, вам треба відійти, щоби не отримати забагато шкоди.\n\nЗнищте вежу, щоби завершити навчання."
"[english]basics_AttackTowerBody"	"Towers have a lot of health and launch powerful blasts at enemies. Generally, they target the closest opposing unit, then continue attacking until that unit dies or leaves its range.\n\nIf a Tower begins attacking your hero, you should retreat before you take too much damage.\n\nDestroy the tower to complete the tutorial."
"basics_objective_KillTowerTitle"	"Знищте ворожу вежу"
"[english]basics_objective_KillTowerTitle"	"Destroy the Enemy Tower"
"basics_objective_KillTowerBody"	"Знищте вежу, щоби завершити навчання."
"[english]basics_objective_KillTowerBody"	"Destroy the Tower to complete the tutorial."
"basics_RazorIntroTitle"	"Бій із ворожим героєм"
"[english]basics_RazorIntroTitle"	"Battling Enemy Heroes"
"basics_RazorIntroBody"	"Новий герой приєднався до бою!\n\nRazor приєднався до ворожої команди Пітьми, він спробує добити вежу своєї команди своїми блискавичними здібностями.\n\nАтакуйте Razor, щоб він відступив."
"[english]basics_RazorIntroBody"	"A new hero has entered the battle!\n\nRazor has joined the enemy Dire team, and will try to defend his team's tower with his lightning abilities.\n\nDamaging Razor can force him to retreat."
"basics_WinningIntroTitle"	"Перемога!"
"[english]basics_WinningIntroTitle"	"Victory!"
"basics_WinningIntroBody"	"Відмінно! Ви знищили вежу і завершили вивчення механіки.\n\nТепер ви готові до матчу проти ботів з підказками. Гра проти ботів з підказками проведе вас через повний матч Dota, крок за кроком, за допомогою керованих комп’ютером союзників та ворогів. Хай щастить та гарної гри!"
"[english]basics_WinningIntroBody"	"Well done! You've destroyed the Tower and completed the Mechanics tutorial.\n\nYou are now ready for the Guided Bot Matches. Guided Bot Matches take you through a full match of Dota, step by step, with the help of computer-controlled allies and enemies. Good luck, and have fun!"
"basics_QuestSuccessTitle"	"Ви перемогли!"
"[english]basics_QuestSuccessTitle"	"You Win!"
"basics_QuestSuccessBody"	"Ви успішно виконали завдання."
"[english]basics_QuestSuccessBody"	"You successfully completed the quest."
"basics_QuestFailureTitle"	"Ви програли!"
"[english]basics_QuestFailureTitle"	"You Lose!"
"basics_QuestFailureBody"	"Вам не вдалося виконати завдання."
"[english]basics_QuestFailureBody"	"You failed to complete the quest."
}
